S13世界赛确定采取瑞士轮: S13世界赛确定采取瑞士轮
灰太狼的羊直播称没有经纪人: 灰太狼的羊直播称没有经纪人
边境缉毒警察的110秒: 边境缉毒警察的110秒
韩国男子杀中国妻子未遂获减刑: 韩国男子杀中国妻子未遂获减刑
保洁阿姨夹断猫腿被扣押工资: 保洁阿姨夹断猫腿被扣押工资
印度产新冠假药流入中国市场: 印度产新冠假药流入中国市场
外交部回应暂停向日本游客发放签证: 外交部回应暂停向日本游客发放签证
第十届新国辩: 第十届新国辩
全国大部地区将有雨雪降温天气: 全国大部地区将有雨雪降温天气
明日方舟夜半新皮肤: 明日方舟夜半新皮肤
新加坡卫生部长称不对华入境设限: 新加坡卫生部长称不对华入境设限
劳斯莱斯平均价格首次达50万欧元: 劳斯莱斯平均价格首次达50万欧元
江秋莲说没收到刘鑫70万元赔偿金: 江秋莲说没收到刘鑫70万元赔偿金
导演何平因病去世: 导演何平因病去世
赴韩中国人自费核酸一次8万韩元: 赴韩中国人自费核酸一次8万韩元
雷军卸任小米软件技术公司董事长: 雷军卸任小米软件技术公司董事长
徐静雨谈世界体坛第一人: 徐静雨谈世界体坛第一人
英雄联盟生肖秘宝: 英雄联盟生肖秘宝
太阳4天内发出两次X级耀斑: 太阳4天内发出两次X级耀斑 
中国奇谭 别和偶像见面: 中国奇谭 别和偶像见面
男子保送博士家人宴请全村: 男子保送博士家人宴请全村
坚决反对针对中国歧视性入境限制措施: 坚决反对针对中国歧视性入境限制措施
火影手游新春熊猫: 火影手游新春熊猫
日本海上自卫队护卫舰抛锚: 日本海上自卫队护卫舰抛锚
林俊杰周杰伦可惜没如果合作舞台: 林俊杰周杰伦可惜没如果合作舞台
小说里十几岁倾国倾城的美人: 小说里十几岁倾国倾城的美人
茅台董事长谈茅台冰淇淋: 茅台董事长谈茅台冰淇淋
为什么海水不能浇灭海底火山: 为什么海水不能浇灭海底火山
游戏替家长背了多少黑锅: 游戏替家长背了多少黑锅
朱紫新精灵吐槽: 朱紫新精灵吐槽