暴雪更改魔兽除夕夜活动时间: 暴雪更改魔兽除夕夜活动时间
谁说中国人拍不出科幻片: 谁说中国人拍不出科幻片
刘培强: 刘培强今天出生了
刘畊宏活过一百岁健身操: 刘畊宏活过一百岁健身操
中国女子在泰国预订到警车接机: 中国女子在泰国预订到警车接机
Steam新年特卖史低游戏: Steam新年特卖史低游戏
女子坚持每年春节看望救命恩人: 女子坚持每年春节看望救命恩人
当女明星体验做农民儿媳妇: 当女明星体验做农民儿媳妇
老外春节档最想看的电影: 老外春节档最想看的电影
日本11.6万人在线看春晚: 日本11.6万人在线看春晚
棒球运动员为何要刺杀海森堡: 棒球运动员为何要刺杀海森堡
交换人生你看了吗: 交换人生你看了吗
第一次放加特林像上战场: 第一次放加特林像上战场
魔兽国服告别烟花表演: 魔兽国服告别烟花表演
张大仙抽到了6颗荣耀水晶: 张大仙抽到了6颗荣耀水晶
老外沉迷璃月众仙造型: 老外沉迷璃月众仙造型
春晚沈腾临场改词: 春晚沈腾临场改词
最没用植物评选大赛: 最没用植物评选大赛
海外版春晚 反弹琵琶: 海外版春晚 反弹琵琶
给垃圾房的大爷大妈准备年夜饭: 给垃圾房的大爷大妈准备年夜饭
满江红: 满江红估计要炸
满江红含腾量超高: 满江红含腾量超高
县城过年现状: 县城过年现状
沈腾马丽 坑: 沈腾马丽 坑
流浪地球2首日票房破三亿: 流浪地球2首日票房破三亿
靠抢才能吃的川菜: 靠抢才能吃的川菜
Steam游戏新史低清仓价: Steam游戏新史低清仓价
HLE不敌LSB: HLE不敌LSB
马丽称上台时鞋跟意外断掉: 马丽称上台时鞋跟意外断掉
终于见到了课本上的五彩大公鸡: 终于见到了课本上的五彩大公鸡