满江红: 满江红估计要炸
流浪地球2比第1部炸裂: 流浪地球2比第1部炸裂
UP主COS格温跳剪纸舞: UP主COS格温跳剪纸舞
刘培强: 刘培强今天出生了
老外沉迷璃月众仙造型: 老外沉迷璃月众仙造型
C罗零点为中国球迷送祝福: C罗零点为中国球迷送祝福
暴雪更改魔兽除夕夜活动时间: 暴雪更改魔兽除夕夜活动时间
马丽称上台时鞋跟意外断掉: 马丽称上台时鞋跟意外断掉
女子坚持每年春节看望救命恩人: 女子坚持每年春节看望救命恩人
终于见到了课本上的五彩大公鸡: 终于见到了课本上的五彩大公鸡
中国女子在泰国预订到警车接机: 中国女子在泰国预订到警车接机
我在B站看杀猪: 我在B站看杀猪
沙溢说拍戏时郭帆希望他圆一点: 沙溢说拍戏时郭帆希望他圆一点
蔡明 刘谦: 蔡明当托把刘谦整崩溃了
LOL竟然有假的攻击力: LOL竟然有假的攻击力
检测声优们的二次元浓度: 检测声优们的二次元浓度
第一次放加特林像上战场: 第一次放加特林像上战场
最没用植物评选大赛: 最没用植物评选大赛
春晚沈腾临场改词: 春晚沈腾临场改词
流浪地球2首日票房破三亿: 流浪地球2首日票房破三亿
沈腾马丽 坑: 沈腾马丽 坑
Steam游戏新史低清仓价: Steam游戏新史低清仓价
HLE不敌LSB: HLE不敌LSB
王者十大上分战神: 王者十大上分战神
明日之后联动流浪地球2: 明日之后联动流浪地球2
Steam新年特卖史低游戏: Steam新年特卖史低游戏
张大仙抽到了6颗荣耀水晶: 张大仙抽到了6颗荣耀水晶
深海好看吗: 深海好看吗
新年特别版龙吟: 新年特别版龙吟
棒球运动员为何要刺杀海森堡: 棒球运动员为何要刺杀海森堡