春晚惊现4090Ti: 春晚惊现4090Ti
沈腾马丽 坑: 沈腾马丽 坑
神厨小福贵最终结局: 神厨小福贵最终结局是什么
流浪地球2首日票房破三亿: 流浪地球2首日票房破三亿
春晚沈腾临场改词: 春晚沈腾临场改词
中国奇谭: 中国奇谭小满更新
马丽称鞋跟断掉是意外: 马丽称鞋跟断掉是意外
俄宇航员从太空拍除夕夜的中国: 俄宇航员从太空拍除夕夜的中国
流浪地球2: 流浪地球2震撼体验
伪人测试: 震惊全球的伪人测试
UP主cos神还原申鹤: UP主cos神还原申鹤
王勉李诞看春晚脱口秀: 王勉李诞看春晚脱口秀
Steam游戏新史低清仓价: Steam游戏新史低清仓价
这个mod把半条命2变成了RTS: 这个mod把半条命2变成了RTS
这些蚂蚁间谍是如何骗过我们双眼的: 这些蚂蚁间谍是如何骗过我们双眼的
伍六七 一二集剧情解析: 伍六七 一二集剧情解析
JDG绝密档案: JDG绝密档案
ESPN全美排名更新: ESPN全美排名更新
请德国流浪汉过春节吃饺子: 请德国流浪汉过春节吃饺子
就你是玄武国的最强刺客: 就你是玄武国的最强刺客
伊藤润二式中二: 伊藤润二式中二
感动女友的99件小事: 感动女友的99件小事
年夜饭不能少的一道菜: 年夜饭不能少的一道菜
春晚 是妈妈是女儿: 春晚 是妈妈是女儿
初一到初七的衣服都配好了: 初一到初七的衣服都配好了
九种语言版多远都要在一起: 九种语言版多远都要在一起
派蒙模仿留云真君: 派蒙模仿留云真君
李信兔年限定皮肤bug: 李信兔年限定皮肤bug
蔡明 刘谦: 蔡明当托把刘谦整崩溃了
谷爱凌拿下兔年首金: 谷爱凌拿下兔年首金