加拿大鹅的噩梦: 豆瓣9.5分加拿大鹅的噩梦
暴雪修改炉石禁内地居民参赛公告: 暴雪修改炉石禁内地居民参赛公告
中国造出世界最薄手撕钢: 中国造出世界最薄手撕钢
深圳房价首次跌破政府指导线: 深圳房价首次跌破政府指导线
原神角色演示艾邢育森: 原神角色演示艾邢育森
晒晒我家年夜饭: 晒晒我家年夜饭
追男生有多难: 追男生有多难
名学6个人凑不出一对好耳朵: 名学6个人凑不出一对好耳朵
甄嬛传全体员工给您拜年啦: 甄嬛传全体员工给您拜年啦
蒲熠星模拟人生搞笑捏脸: 蒲熠星模拟人生搞笑捏脸
刺客首领和烂命华谁更厉害: 刺客首领和烂命华谁更厉害
王宝强春晚三个节目: 王宝强春晚三个节目
漠叔新片: 漠叔新片票房突破100块钱
刘青松称以前觉得Theshy高冷: 刘青松称以前觉得Theshy高冷
LOL手游登录游戏送两款皮肤: LOL手游登录游戏送两款皮肤
艾热宝石老舅登上央视春晚: 艾热宝石老舅登上央视春晚
王者荣耀世界: 王者荣耀世界新春新实机
内马尔和姆巴佩的兔年祝福: 内马尔和姆巴佩的兔年祝福
5分钟学会文明6永乐大帝: 5分钟学会文明6永乐大帝
语言暴力到底有多可怕: 语言暴力到底有多可怕
姜广涛一案曝后续: 姜广涛一案曝后续
38年前的三国游戏: 38年前的三国游戏
阿信说内地演唱会不止一场: 阿信说内地演唱会不止一场
原神3.4千壑沙地能拿多少原石: 原神3.4千壑沙地能拿多少原石
德国伯父吃春节豪华大餐: 德国伯父吃春节豪华大餐
压岁钱竟然是这么来的: 压岁钱竟然是这么来的
奶茶的误解和谣言: 奶茶的误解和谣言
奥林匹斯变成世界尽头: 奥林匹斯变成世界尽头
暗信新赛季最强打法: 暗信新赛季最强打法
GTA线上首次推出春节活动: GTA线上首次推出春节活动