我国阳后出现肺炎人群约为8％: 我国阳后出现肺炎人群约为8％
日本举行史上最大规模女子相扑赛: 日本举行史上最大规模女子相扑赛
狼队小胖彻底变了: 狼队小胖彻底变了
官方通报女子去世后有疫苗记录: 官方通报女子去世后有疫苗记录
上海警方调查玲娜贝儿头部被拍打: 上海警方调查玲娜贝儿头部被拍打
山东发现距今1.32万年人类遗址: 山东发现距今1.32万年人类遗址
社恐cos波奇酱在海底捞社死: 社恐cos波奇酱在海底捞社死
用空气炸锅炸薯条6分钟后起火: 用空气炸锅炸薯条6分钟后起火
墨西哥特种部队海滩演习吓退游客: 墨西哥特种部队海滩演习吓退游客
地球没了黑夜人类会怎么样: 地球没了黑夜人类会怎么样
垫底辣妹: 垫底辣妹上线B站
三亚海边多人疑因地域问题拌嘴互殴: 三亚海边多人疑因地域问题拌嘴互殴
喜羊羊竟成反派: 喜羊羊竟成反派
20元的康师傅鸳鸯锅泡面: 20元的康师傅鸳鸯锅泡面
抗日神剧特效不如鬼畜区平均水平: 抗日神剧特效不如鬼畜区平均水平
天才MMA选手李胜惠离世: 天才MMA选手李胜惠离世
中国人造太阳又有重大发现: 中国人造太阳又有重大发现
超级IP版权有多值钱: 超级IP版权有多值钱
电影梅根 机械萝莉: 电影梅根 机械萝莉
Lisa演唱会看到青你2学员的反应: Lisa演唱会看到青你2学员的反应
UP和UP结婚了: 又有UP和UP结婚了
不让孩子们看热舞的樱花: 不让孩子们看热舞的樱花
曝明日方舟被抄袭: 曝明日方舟被抄袭
原神3.4申鹤没了: 原神3.4申鹤没了
尸体派对2讲了什么故事: 尸体派对2讲了什么故事
两轮电动车是如何改变城市的: 两轮电动车是如何改变城市的
阳康之后声音更磁性了: 阳康之后声音更磁性了
杨戬 我被动呢: 杨戬 我被动呢
麦当劳CEO宣布将裁员: 麦当劳CEO宣布将裁员
名场面总在不经意间产生: 名场面总在不经意间产生