Showmaker对LOL失去热情: Showmaker对LOL失去热情
我放弃了: 我放弃了在学校开养猪场
可口可乐联名手机开箱: 可口可乐联名手机开箱
复旦MOSS团队致歉: 复旦MOSS团队致歉
战鹰转行皮套人: 战鹰转行皮套人
老板出现了暗恋的症状: 老板出现了暗恋的症状
儿童电影看出恐怖片的感觉: 儿童电影看出恐怖片的感觉
我放弃了月球实景爆破: 我放弃了月球实景爆破
Xbox游戏上线Switch: Xbox游戏上线Switch
当哈士奇第一次见到羊: 当哈士奇第一次见到羊
考研四六级查分遇龙抬头: 考研四六级查分遇龙抬头
考研成绩: 考研成绩
东北插班生又杀回来了: 东北插班生又杀回来了
游戏公司们从暴雪挖人: 游戏公司们从暴雪挖人
一把游戏三个献祭流: 一把游戏三个献祭流
1400元主机可玩3A大作: 1400元主机可玩3A大作
甘愿苦等十年的神番: 甘愿苦等十年的神番
Steam10款游戏背刺史低: Steam10款游戏背刺史低
梅西绝杀后返回巴塞罗那: 梅西绝杀后返回巴塞罗那
显卡销量排行出炉: 显卡销量排行出炉
龙抬头将在21日晚间上演: 龙抬头将在21日晚间上演
国外音乐人评价爱如火: 国外音乐人评价爱如火
上海暂停体育中考: 上海暂停体育中考
国内首个类ChatGPT模型: 国内首个类ChatGPT模型
犯罪恐怖片无边泳池: 犯罪恐怖片无边泳池
大熊猫香香回国: 大熊猫香香回国
汪峰全国巡演正式官宣: 汪峰全国巡演正式官宣
原子之心今日首发: 原子之心今日首发
最良心的国产泡面: 最良心的国产泡面
老戴玩原子之心: 老戴玩原子之心