京海全是双开门身材: 京海全是双开门身材
年轻人为什么怕进理发店: 年轻人为什么怕进理发店
拼夕夕3块一罐的鲍鱼: 拼夕夕3块一罐的鲍鱼
女生考研437分喜极而泣: 女生考研437分喜极而泣
WBG IG: WBG战胜IG
我放弃了: 我放弃了在学校开养猪场
Showmaker对LOL失去热情: Showmaker对LOL失去热情
老板出现了暗恋的症状: 老板出现了暗恋的症状
铃芽之旅你的名字版预告: 铃芽之旅你的名字版预告
LOL最受欢迎皮肤: LOL最受欢迎皮肤
居然有人去漫展cos他: 居然有人去漫展cos他
儿童电影看出恐怖片的感觉: 儿童电影看出恐怖片的感觉
项羽专精装终于削弱: 项羽专精装终于削弱
莉可丽丝凭啥这么火: 莉可丽丝凭啥这么火
S2全传说局内演示: S2全传说局内演示
上海暂停体育中考: 上海暂停体育中考
阳光开朗大ShyShy: 阳光开朗大ShyShy
Luxiem与KFC联动: Luxiem与KFC联动
命运方舟即将内测: 命运方舟即将内测
韩国兄妹体验延边特色: 韩国兄妹体验延边特色
新人皇李培楠来B站了: 新人皇李培楠来B站了
初印象好但处不久的同学: 初印象好但处不久的同学
国内首个类ChatGPT模型: 国内首个类ChatGPT模型
鹅鸭杀制作人剧透: 鹅鸭杀制作人剧透
未央趴玻璃看一诺直播: 未央趴玻璃看一诺直播
元歌三技能再次大改: 元歌三技能再次大改
中国最后的儒家宰相: 中国最后的儒家宰相
赏龙抬头星空: 赏龙抬头星空
东北插班生又杀回来了: 东北插班生又杀回来了
Xbox游戏上线Switch: Xbox游戏上线Switch