年轻人为什么怕进理发店: 年轻人为什么怕进理发店
京海全是双开门身材: 京海全是双开门身材
WBG IG: WBG战胜IG
女生考研437分喜极而泣: 女生考研437分喜极而泣
拼夕夕3块一罐的鲍鱼: 拼夕夕3块一罐的鲍鱼
Showmaker对LOL失去热情: Showmaker对LOL失去热情
我放弃了: 我放弃了在学校开养猪场
原神巴黎艺术展: 原神巴黎艺术展
老板出现了暗恋的症状: 老板出现了暗恋的症状
爬上了中国最高树: 爬上了中国最高树
90后最大弱点: 90后最大弱点
哈利波特全新时装: 哈利波特全新时装预告
新人皇李培楠来B站了: 新人皇李培楠来B站了
LOL最受欢迎皮肤: Reddit LOL最受欢迎皮肤
FPS皮肤: FPS国风修仙皮肤
大学生实习: 大学生实习无语瞬间
居然有人去漫展cos他: 居然有人去漫展cos他
儿童电影看出恐怖片的感觉: 儿童电影看出恐怖片的感觉
成为村里所有老人的女儿: 成为村里所有老人的女儿
元歌三技能再次大改: 元歌三技能再次大改
Apex亚马逊游戏会员奖励: Apex亚马逊游戏会员奖励
机械飞升能实现吗: 机械飞升能实现吗
柯洁请客战鹰探店: 柯洁请客战鹰探店
S2全传说局内演示: S2全传说局内演示
上学时经历的生死时刻: 上学时经历的生死时刻
上海暂停体育中考: 上海暂停体育中考
命运方舟即将内测: 命运方舟即将内测
莉可丽丝凭啥这么火: 莉可丽丝凭啥这么火
国服关羽: 国服关羽的气魄
广州早茶: 广州早茶白月光