Showmaker对LOL失去热情: Showmaker对LOL失去热情
我放弃了: 我放弃了在学校开养猪场
老板出现了暗恋的症状: 老板出现了暗恋的症状
复旦MOSS团队致歉: 复旦MOSS团队致歉
战鹰转行皮套人: 战鹰转行皮套人
可口可乐联名手机开箱: 可口可乐联名手机开箱
OMG UP: OMG UP
居然有人去漫展cos他: 居然有人去漫展cos他
大熊猫香香回国: 大熊猫香香回国
人生的惯性定律: 人生的惯性定律
希儿越级单通最高难度本: 希儿越级单通最高难度本
Steam10款游戏背刺史低: Steam10款游戏背刺史低
考研四六级查分遇龙抬头: 考研四六级查分遇龙抬头
考研成绩: 考研成绩
儿童电影看出恐怖片的感觉: 儿童电影看出恐怖片的感觉
Xbox游戏上线Switch: Xbox游戏上线Switch
游戏公司们从暴雪挖人: 游戏公司们从暴雪挖人
云顶九层魔盗团: 云顶九层魔盗团
1400元主机可玩3A大作: 1400元主机可玩3A大作
我放弃了月球实景爆破: 我放弃了月球实景爆破
梅西绝杀后返回巴塞罗那: 梅西绝杀后返回巴塞罗那
显卡销量排行出炉: 显卡销量排行出炉
狂蟒惊魂: 狂蟒惊魂上线B站
这就是中国: 这就是中国更新
真有小孩上学这么开心: 真有小孩上学这么开心
当流浪狗遇到有主人的狗: 当流浪狗遇到有主人的狗
音悦台或将回归: 音悦台或将回归
原子之心最高难度: 原子之心最高难度
甘愿苦等十年的神番: 甘愿苦等十年的神番
汪峰全国巡演正式官宣: 汪峰全国巡演正式官宣