年轻人为什么怕进理发店: 年轻人为什么怕进理发店
京海全是双开门身材: 京海全是双开门身材
Showmaker对LOL失去热情: Showmaker对LOL失去热情
女生考研437分喜极而泣: 女生考研437分喜极而泣
我放弃了: 我放弃了在学校开养猪场
老板出现了暗恋的症状: 老板出现了暗恋的症状
居然有人去漫展cos他: 居然有人去漫展cos他
我放弃了月球实景爆破: 我放弃了月球实景爆破
WBG IG: WBG战胜IG
国内首个类ChatGPT模型: 国内首个类ChatGPT模型
皮特白金局22杀: 皮特白金局22杀
Luxiem与KFC联动: Luxiem与KFC联动
LOL最受欢迎皮肤: Reddit LOL最受欢迎皮肤
汪峰全国巡演正式官宣: 汪峰全国巡演正式官宣
XSS试玩原子之心: XSS试玩原子之心
柯南剧场版最新预告: 柯南剧场版最新预告
刘谦魔术课2023第一课: 刘谦魔术课2023第一课
淘宝丑东西博物馆: 淘宝丑东西博物馆
爱如火 让猛男劈叉又抢拍: 爱如火 让猛男劈叉又抢拍
我的世界末影龙农场: 我的世界末影龙农场
被快餐淹没的神作: 被快餐淹没的神作
中国最后的儒家宰相: 中国最后的儒家宰相
Apex战争机器返场: Apex战争机器返场
东北得莫利炖鱼: 东北得莫利炖鱼
国产动画入围柏林电影节: 国产动画入围柏林电影节
土卫六的真实面貌: 土卫六的真实面貌
电车油车谁更省: 电车油车谁更省
柯洁请客战鹰探店: 柯洁请客战鹰探店
守夜人限定金时装爆料: 守夜人限定金时装爆料
莉可丽丝凭啥这么火: 莉可丽丝凭啥这么火