小栗旬给消防员剪发: 小栗旬给消防员剪发
考研四六级查分遇龙抬头: 考研四六级查分遇龙抬头
战鹰转行皮套人: 战鹰转行皮套人
Steam10款游戏背刺史低: Steam10款游戏背刺史低
龙抬头将在21日晚间上演: 龙抬头将在21日晚间上演
考研成绩: 考研成绩
一把游戏三个献祭流: 一把游戏三个献祭流
国产动画入围柏林电影节: 国产动画入围柏林电影节
梅西绝杀后返回巴塞罗那: 梅西绝杀后返回巴塞罗那
STARSHIP公告移除宇少: STARSHIP公告移除宇少
国服猪妹COS: 国服猪妹COS
森林之子多人模式预告: 森林之子多人模式预告
国内首个类ChatGPT模型: 国内首个类ChatGPT模型
免费领类似动森的游戏: 免费领类似动森的游戏
老戴玩原子之心: 老戴玩原子之心
最良心的国产泡面: 最良心的国产泡面
成本仅5万的中式恐怖片: 成本仅5万的中式恐怖片
中国革命性水稻突破: 中国革命性水稻突破
感谢B站送来的女朋友: 感谢B站送来的女朋友
XSS试玩原子之心: XSS试玩原子之心
柯南剧场版最新预告: 柯南剧场版最新预告
小龙人贝贝扮演者去世: 小龙人贝贝扮演者去世
Apex战争机器返场: Apex战争机器返场
守夜人限定金时装爆料: 守夜人限定金时装爆料
小钰看Rookie和杰克比心: 小钰看Rookie和杰克比心
全网最硬核龙抬头: 全网最硬核龙抬头
TXT迟到问题不大: TXT迟到问题不大
11人大战25英雄西津渡: 11人大战25英雄西津渡
盘点近期解散的女团: 盘点近期解散的女团
西游记副导演任凤坡去世: 西游记副导演任凤坡去世