年轻人为什么怕进理发店: 年轻人为什么怕进理发店
Showmaker对LOL失去热情: Showmaker对LOL失去热情
OMG UP: OMG UP
复旦MOSS团队致歉: 复旦MOSS团队致歉
战鹰转行皮套人: 战鹰转行皮套人
我放弃了: 我放弃了在学校开养猪场
可口可乐联名手机开箱: 可口可乐联名手机开箱
老板出现了暗恋的症状: 老板出现了暗恋的症状
居然有人去漫展cos他: 居然有人去漫展cos他
无宫斗版甄嬛传: 无宫斗版甄嬛传
莉可丽丝凭啥这么火: 莉可丽丝凭啥这么火
考研出成绩后重要提醒: 考研出成绩后重要提醒
儿童电影看出恐怖片的感觉: 儿童电影看出恐怖片的感觉
游戏公司们从暴雪挖人: 游戏公司们从暴雪挖人
这就是中国: 这就是中国更新
哈利波特手游三月直售: 哈利波特手游三月直售
1400元主机可玩3A大作: 1400元主机可玩3A大作
我放弃了月球实景爆破: 我放弃了月球实景爆破
Xbox游戏上线Switch: Xbox游戏上线Switch
中国最后的儒家宰相: 中国最后的儒家宰相
屯屯鼠六百多抽能出什么: 屯屯鼠六百多抽能出什么
云顶九层魔盗团: 云顶九层魔盗团
一把游戏三个献祭流: 一把游戏三个献祭流
狂蟒惊魂: 狂蟒惊魂上线B站
梅西绝杀后返回巴塞罗那: 梅西绝杀后返回巴塞罗那
显卡销量排行出炉: 显卡销量排行出炉
大熊猫香香回国: 大熊猫香香回国
骆歆模仿美少女战士: 骆歆模仿美少女战士
UP算出李有田车速: UP算出李有田车速
龙抬头将在21日晚间上演: 龙抬头将在21日晚间上演