WBG IG: WBG IG
年轻人为什么怕进理发店: 年轻人为什么怕进理发店
京海全是双开门身材: 京海全是双开门身材
女生考研437分喜极而泣: 女生考研437分喜极而泣
我放弃了: 我放弃了在学校开养猪场
Showmaker对LOL失去热情: Showmaker对LOL失去热情
老板出现了暗恋的症状: 老板出现了暗恋的症状
韩国兄妹体验延边特色: 韩国兄妹体验延边特色
Luxiem与KFC联动: Luxiem与KFC联动
崩坏3终焉: 崩坏3终焉全面解析
儿童电影看出恐怖片的感觉: 儿童电影看出恐怖片的感觉
中国最后的儒家宰相: 中国最后的儒家宰相
新人皇李培楠来B站了: 新人皇李培楠来B站了
铃芽之旅你的名字版预告: 铃芽之旅你的名字版预告
Xbox游戏上线Switch: Xbox游戏上线Switch
出成绩前的考研人: 出成绩前的考研人
屯屯鼠六百多抽能出什么: 屯屯鼠六百多抽能出什么
希儿越级单通最高难度本: 希儿越级单通最高难度本
当我转入尖子班: 当我转入尖子班
欢迎再次登录预告: 欢迎再次登录预告
老戴玩原子之心: 老戴玩原子之心
漫展模仿COD19处决: 漫展模仿COD19处决
36元猪肚鸡自助小火锅: 36元猪肚鸡自助小火锅
我放弃了月球实景爆破: 我放弃了月球实景爆破
Rookie 一剑诛饿: Rookie 一剑诛饿 
原子之心最高难度流程: 原子之心最高难度流程
曝LOL狗熊艾翁将小重做: 曝LOL狗熊艾翁将小重做
莉可丽丝凭啥这么火: 莉可丽丝凭啥这么火
考研复试需搞清的12个问题: 考研复试需搞清的12个问题
居然有人去漫展cos他: 居然有人去漫展cos他