考研四六级查分遇龙抬头: 考研四六级查分遇龙抬头
考研成绩: 考研成绩
国产动画入围柏林电影节: 国产动画入围柏林电影节
龙抬头将在21日晚间上演: 龙抬头将在21日晚间上演
梅西绝杀后返回巴塞罗那: 梅西绝杀后返回巴塞罗那
一把游戏三个献祭流: 一把游戏三个献祭流
国服猪妹COS: 国服猪妹COS
森林之子多人模式预告: 森林之子多人模式预告
全网最硬核龙抬头: 全网最硬核龙抬头
阿水三局线杀: 阿水三局线杀
假装被骂哭看男友反应: 假装被骂哭看男友反应
中国革命性水稻突破: 中国革命性水稻突破
免费领类似动森的游戏: 免费领类似动森的游戏
红警基地压肉人一块地: 红警基地压肉人一块地
学习是为了什么: 学习是为了什么
感谢B站送来的女朋友: 感谢B站送来的女朋友
最良心的国产泡面: 最良心的国产泡面
守夜人限定金时装爆料: 守夜人限定金时装爆料
小钰看Rookie和杰克比心: 小钰看Rookie和杰克比心
TXT迟到问题不大: TXT迟到问题不大
11人大战25英雄西津渡: 11人大战25英雄西津渡
盘点近期解散的女团: 盘点近期解散的女团
西游记副导演任凤坡去世: 西游记副导演任凤坡去世
日本有多喜欢熊猫: 日本有多喜欢熊猫
大厂: 大厂裸辞收入翻倍
挑战全网狂飙最细解说: 挑战全网狂飙最细解说
迫害方舟观感爆炸: 迫害方舟观感爆炸
白银说的话就像是: 白银说的话就像是
蚁人3拉跨狂潮: 蚁人3拉跨狂潮
姆巴佩鼓励内马尔: 姆巴佩鼓励内马尔