流浪地球2这是能吐槽的吗: 流浪地球2这是能吐槽的吗
流浪地球2英国首映评论: 流浪地球2英国首映评论
流浪地球2对中国电影的意义: 流浪地球2对中国电影的意义
留学生辟谣网传烟花视频: 留学生辟谣网传烟花视频
女生拒绝相亲被围着做思想工作: 女生拒绝相亲被围着做思想工作
妹妹想起还有7本作业瞬间崩溃: 妹妹想起还有7本作业瞬间崩溃
Doinb: Doinb
LOL猫咪重做技能曝光: LOL猫咪重做技能曝光
杨迪 这次分手和离婚无异: 杨迪 这次分手和离婚无异
惟有香如故: 惟有香如故第三集
于敏的计算能力有多逆天: 于敏的计算能力有多逆天
那些复活成功和失败的知名游戏: 那些复活成功和失败的知名游戏
狂飙刀哥居然是卧底: 狂飙刀哥居然是卧底
原味大肠顶级厨师愈涛最新回应: 原味大肠顶级厨师愈涛最新回应
军港封锁区实现全装自由方法: 军港封锁区实现全装自由方法
icon妈妈 不要在网上吵架了: icon妈妈 不要在网上吵架了
流浪地球2中太空电梯能实现吗: 流浪地球2中太空电梯能实现吗
法国标致生产的咖啡研磨机: 法国标致生产的咖啡研磨机
伍六七声优都长什么样: 伍六七声优都长什么样
Ame 萧瑟但是无人声版: Ame 萧瑟但是无人声版
男子过年看电影买到无座票: 男子过年看电影买到无座票
兔年就由玉总来守护: 兔年就由玉总来守护
内娱舞台也有疯批帅哥了: 内娱舞台也有疯批帅哥了
零下30度把iPhone冰冻48小时: 零下30度把iPhone冰冻48小时
流浪地球2的黑科技耳机: 流浪地球2的黑科技耳机如何设计
郑乃馨: 郑乃馨 约定
三国杀史上最折磨组合: 三国杀史上最折磨组合
植物大战僵尸 魅惑射手: 植物大战僵尸 魅惑射手
梅西 给你俩窝窝: 梅西 给你俩窝窝获传播类大奖
当玩说唱的奶奶给孙子做吃的: 当玩说唱的奶奶给孙子做吃的