多人因假冒王思聪行骗被判刑: 多人因假冒王思聪行骗被判刑
孙悟空新皮肤齐天大圣: 孙悟空新皮肤齐天大圣
Ruler居然能全程中文交流了: Ruler居然能全程中文交流了
男孩玩家长手机误点14份披萨: 男孩玩家长手机误点14份披萨
奶奶去世爸爸吹奏世上只有妈妈好: 奶奶去世爸爸吹奏世上只有妈妈好
尼泊尔一架客机坠毁: 尼泊尔一架客机坠毁
新国辩决赛北大VS暨大: 新国辩决赛北大VS暨大
陈奕迅被自己演唱会票价震惊到: 陈奕迅被自己演唱会票价震惊到
王冰冰原地下班秒睡着: 王冰冰原地下班秒睡着
LGD RA: LGD RA
桂林一酒吧卫生间疑装双面镜: 桂林一酒吧卫生间疑装双面镜
贵州3名幼童失踪一夜在山上获救: 贵州3名幼童失踪一夜在山上获救
为什么使用哈兰德陷入瓶颈: 为什么使用哈兰德陷入瓶颈
尹烨称白肺可能不是新冠感染: 尹烨称白肺可能不是新冠感染
吴镇宇没鼓掌: 吴镇宇没鼓掌
凌晨回家12名亲人在路边等候: 凌晨回家12名亲人在路边等候
俄罗斯猎狼犬被网友玩坏了: 俄罗斯猎狼犬被网友玩坏了
西伯利亚现零下73℃低温: 西伯利亚现零下73℃低温
XBB可能缩短免疫保护期: XBB可能缩短免疫保护期
我的青春恋爱物语果然有问题PV: 我的青春恋爱物语果然有问题PV
如何看待切尔西截胡阿森纳: 如何看待切尔西截胡阿森纳
元气骑士 迷迭香和七里香: 元气骑士 迷迭香和七里香
罗翔谈行政拘留暂缓执行制度: 罗翔谈行政拘留暂缓执行制度
独生女远嫁过年和老公决定各找各妈: 独生女远嫁过年和老公决定各找各妈
中国奇谭更新: 中国奇谭乡村巴士更新
兔年限定皮肤山海有灵: 王者兔年限定皮肤山海有灵
会英语和不会英语的都沉默了: 会英语和不会英语的都沉默了
上海迪士尼烟花秀被大雾笼罩: 上海迪士尼烟花秀被大雾笼罩
如果在十八: 如果在十八我没能忽悠他
魈PV短片录制事故: 魈PV短片录制事故