神女劈观登上网络春晚: 神女劈观登上网络春晚
如果在十八: 如果在十八我没能忽悠他
侯翠翠 拿了百大不装了: 侯翠翠 拿了百大不装了
桂林一酒吧卫生间疑装双面镜: 桂林一酒吧卫生间疑装双面镜
化妆品被6岁表妹全抠碎: 化妆品被6岁表妹全抠碎
仅一位观众戏曲演员坚持演出: 仅一位观众戏曲演员坚持演出
ZC领奖把衣服脱了: ZC领奖把衣服脱了
下雪: 下雪
文明6新增中国领袖: 文明6新增中国领袖
Uzi看Ruler首秀五杀: Uzi看Ruler首秀五杀
国际足联调查阿根廷队世界杯不当行为: 国际足联调查阿根廷队世界杯不当行为
rookie说theshy想解封要写申请: rookie说theshy想解封要写申请
寄养后小猫拨来视频电话: 寄养后小猫拨来视频电话
女子亲人去世请假遭老板怼: 女子亲人去世请假遭老板怼
微信新版本特性: 微信新版本特性有多离谱
兔年限定皮肤山海有灵: 王者兔年限定皮肤山海有灵
Aespa空降KB见面会: Aespa空降KB见面会
百大UP主获奖感言第4弹: 百大UP主获奖感言第4弹
小草神爬到天空岛: 小草神爬到天空岛
Ruler首秀五杀: Ruler首秀五杀
中国奇谭为何让打工人泪崩: 中国奇谭为何让打工人泪崩
深海大圣归来联动短片: 深海大圣归来联动短片
网易暴雪运营员工大部分已离职: 网易暴雪运营员工大部分已离职
拉宏桑采访百万粉UP主: 拉宏桑采访百万粉UP主
红警HBK08百大获奖感言: 红警HBK08百大获奖感言
俄称不对中国旅客额外设限: 俄称不对中国旅客额外设限
Doinb 在线求职: Doinb 在线求职
60年前的国漫有多能打: 60年前的国漫有多能打
曼联2-1逆转曼城: 曼联2-1逆转曼城
千万不要在家给杜宾洗澡: 千万不要在家给杜宾洗澡