我国新发现1颗近地小行星: 我国新发现1颗近地小行星
米哈游春招空中宣讲会: 米哈游春招空中宣讲会
LOL卡特琳娜原画: LOL卡特琳娜原画
室温超导要来了吗: 室温超导要来了吗
张颂文向张纪中道歉: 张颂文向张纪中道歉
建议幼儿园入园年龄低龄化: 建议幼儿园入园年龄低龄化
真实锐评TES选手道歉: 真实锐评TES选手道歉
慧小媛COS狂飙大嫂: 慧小媛COS狂飙大嫂
百草味回应土豆片只有1片: 百草味回应土豆片只有1片
新英雄米利欧大招测试: 新英雄米利欧大招测试
新考研二人组: 新考研二人组
国产年度催泪神作: 国产年度催泪神作
LOL武器开E魂环特效: LOL武器开E魂环特效
麒麟夜刀的三技能: 麒麟夜刀的三技能
搜魔人上架Steam: 搜魔人上架Steam
云顶洲际赛幻灭夺冠: 云顶洲际赛幻灭夺冠
谁还没看东京女孩走秀: 谁还没看东京女孩走秀
电视上离职为何会抱纸箱: 电视上离职为何会抱纸箱
UP在法国街头古筝炸街: UP在法国街头古筝炸街
OMG AL: OMG战胜AL
拳头公司鬼蟹宣布离职: 拳头公司鬼蟹宣布离职
恭喜你成为一名妇女: 恭喜你成为一名妇女
伍六七4 阿七白狐决战: 伍六七4 阿七白狐决战
四大名著合订本: 四大名著合订本
Apex改版的密客有多强: Apex改版的密客有多强
666元一份的新疆大盘鸡: 666元一份的新疆大盘鸡
LOL人马基础原画更新: LOL人马基础原画更新
复联5奇异博士成反派: 复联5奇异博士成反派
杭州法喜寺500岁玉兰盛放: 杭州法喜寺500岁玉兰盛放
今日显卡价格: 今日显卡价格