UP EDG: UP EDG
豆瓣90万人好评的悬疑片: 豆瓣90万人好评的悬疑片
为何悟空最受排挤: 为何悟空最受排挤
2040高考人数或降至600万: 2040高考人数或降至600万
Wei盘佛珠: 比赛暂停时Wei盘佛珠
王者云缨史诗级加强: 王者云缨史诗级加强
TheShy的爆杀流鳄鱼: TheShy的爆杀流鳄鱼
爱如火是什么阴间歌曲: 爱如火是什么阴间歌曲
哪个省省考最难: 哪个省省考最难
STEAM本周最值入手史低: STEAM本周最值入手史低
卖肥牛虾滑卷能赚多少: 卖肥牛虾滑卷能赚多少
比亚迪原地掉头什么原理: 比亚迪原地掉头什么原理
森林之子全食用动画: 森林之子全食用动画
三无少女发展史: 三无少女发展史
爱在西元前: 爱在西元前快过期了
被要求上进的年轻人: 被要求上进的年轻人
电车难题解决方案分析: 电车难题解决方案分析
无刘海美貌翻倍是真的: 无刘海美貌翻倍是真的
阳光开朗大鲶鱼: 阳光开朗大鲶鱼
苏轼: 苏轼穿越能评院士吗
巴奴火锅再回应天价土豆: 巴奴火锅再回应天价土豆
阿冰退出农村三人行: 阿冰退出农村三人行
暗能量来源于黑洞吗: 暗能量来源于黑洞吗
原子之心 真正的艺术品: 原子之心 真正的艺术品
榛子巧克力千层: 沉浸吃榛子巧克力千层
RNG TT: RNG战胜TT
青年雷影实战演示: 青年雷影实战演示
黑柳彻子也是香香迷妹: 黑柳彻子也是香香迷妹
黄子华新电影值得看吗: 黄子华新电影值得看吗
修炼到极致的枫原万叶: 修炼到极致的枫原万叶