Theshy复盘落后8千翻盘JDG: Theshy复盘落后8千翻盘JDG
中国电竞创造历史一冠: 中国电竞创造历史一冠
Xiaohu: Xiaohu来B站了
北京近期发生4级以上地震可能性不大: 北京近期发生4级以上地震可能性不大
李培楠: 李培楠
NASA拍到太阳北极一块断裂脱落: NASA拍到太阳北极一块断裂脱落
霍格沃茨之遗Steam销量碾压: 霍格沃茨之遗Steam销量碾压
日照附近海域发现不明飞行物: 日照附近海域发现不明飞行物
姐姐放弃考研捐骨髓救17岁妹妹: 姐姐放弃考研捐骨髓救17岁妹妹
腾讯视频回应多设备登录被封号: 腾讯视频回应多设备登录被封号
人类如何走过喝水要命的年代: 人类如何走过喝水要命的年代
国产二次元手游全球流水榜: 国产二次元手游全球流水榜
印度呼吁情人节抱奶牛: 印度呼吁情人节抱奶牛
最残忍的死缓判决: 世界上最残忍的死缓判决
女子搬家前用3D扫描保存房间: 女子搬家前用3D扫描保存房间
蕾哈娜挺孕肚表演: 蕾哈娜挺孕肚表演
魔兽之父想把游戏改编为动画: 魔兽之父想把游戏改编为动画
WBG绝境翻盘 拒绝让一追二: WBG绝境翻盘 拒绝让一追二
中国男网历史第一冠: 中国大陆男网历史第一冠
LPL春季赛中单数据雷达图: LPL春季赛中单数据雷达图
李培楠夺冠后兄弟们的反应: 李培楠夺冠后兄弟们的反应
Steam免费爆款 中世纪塔科夫: Steam免费爆款 中世纪塔科夫
甘肃定西对彩礼限高: 甘肃定西对彩礼限高
机械革命旷世16super开箱: 机械革命旷世16super开箱
直播玩APEX英雄: 直播玩APEX英雄
当献祭流雅典娜的队友是何体验: 当献祭流雅典娜的队友是何体验
游戏党最强CPU显卡搭配: 游戏党最强CPU显卡搭配
Rihanna超级碗惊艳全场: Rihanna超级碗惊艳全场
高启栓: 高启栓
开学第一天: 开学第一天现状