中国男网历史第一冠: 中国大陆男网历史第一冠
中国电竞创造历史一冠: 中国电竞创造历史一冠
大宋破壁人秦桧: 大宋破壁人秦桧
我国女性终身无孩率接近10%: 我国女性终身无孩率接近10%
网信办打击借胡鑫宇炒作等行为: 网信办打击借胡鑫宇炒作等行为
霍格沃茨之遗在线人数超80万: 霍格沃茨之遗在线人数超80万
OMG RA: OMG RA
人类如何走过喝水要命的年代: 人类如何走过喝水要命的年代
深圳夜空出现不明飞行物: 深圳夜空出现不明飞行物
ITZY出道四周年见面会: ITZY出道四周年见面会
俄罗斯人看流浪地球2: 俄罗斯人看流浪地球2
速度与激情10超级碗预告: 速度与激情10超级碗预告
甘肃定西对彩礼限高: 甘肃定西对彩礼限高
机械革命旷世16super开箱: 机械革命旷世16super开箱
狂飙钟阿四镜头已全部删除: 狂飙钟阿四镜头已全部删除
衢州交警致歉: 衢州交警致歉
当献祭流雅典娜的队友是何体验: 当献祭流雅典娜的队友是何体验
Theshy复盘落后8千翻盘JDG: Theshy复盘落后8千翻盘JDG
直播玩APEX英雄: 直播玩APEX英雄
游戏党最强CPU显卡搭配: 游戏党最强CPU显卡搭配
真正的埃及人初见须弥反应: 真正的埃及人初见须弥反应
Rihanna超级碗惊艳全场: Rihanna超级碗惊艳全场
最残忍的死缓判决: 世界上最残忍的死缓判决
土耳其大范围抓捕豆腐渣建筑负责人: 土耳其大范围抓捕豆腐渣建筑负责人
日照附近海域发现不明飞行物: 日照附近海域发现不明飞行物
詹姆斯超级碗现场戴皇冠: 詹姆斯超级碗现场戴皇冠
高启栓: 高启栓
开学第一天: 开学第一天现状
苹果CEO库克3月将赴华参会: 苹果CEO库克3月将赴华参会
IEM中国选手夺冠催泪瞬间: IEM中国选手夺冠催泪瞬间