当给俄罗斯岳父5万彩礼: 当给俄罗斯岳父5万彩礼
王者赵怀真幽灵拳BUG: 王者赵怀真幽灵拳BUG
免费永久入库毛茸茸的愤怒: 免费永久入库毛茸茸的愤怒
我国女性终身无孩率接近10%: 我国女性终身无孩率接近10%
网信办打击借胡鑫宇炒作等行为: 网信办打击借胡鑫宇炒作等行为
Tian 天亮: Tian 天亮
香绫神里菱华史诗级会面: 香绫神里菱华史诗级会面
中国男网历史第一冠: 中国大陆男网历史第一冠
手机无线充电为何未普及: 手机无线充电为何未普及
什么是插画的节奏: 什么是插画的节奏
深圳夜空出现不明飞行物: 深圳夜空出现不明飞行物
暴雪推出暗黑破坏神官方食谱: 暴雪推出暗黑破坏神官方食谱
狂飙钟阿四镜头已全部删除: 狂飙钟阿四镜头已全部删除
土耳其强震后橄榄园现巨大断层: 土耳其强震后橄榄园现巨大断层
苹果CEO库克3月将赴华参会: 苹果CEO库克3月将赴华参会
俞涛来整活狂飙了: 俞涛来整活狂飙了
多地实拍小行星Sar2667撞地球: 多地实拍小行星Sar2667撞地球
沈阳的科比主题烧烤店: 沈阳的科比主题烧烤店
宝可梦朱紫弃世猴用法分析: 宝可梦朱紫弃世猴用法分析
衢州交警致歉: 衢州交警致歉
YG新女团成员PHARITA介绍: YG新女团成员PHARITA介绍
闪耀暖暖新角色阿洛伊PV: 闪耀暖暖新角色阿洛伊PV
中国式家长精神续作预告: 中国式家长精神续作预告
Karsa牌灭火器: Karsa牌灭火器
steam新品节试玩体验: steam新品节试玩体验
CSGO G2卡托维兹夺冠: CSGO G2卡托维兹夺冠
蕾哈娜超级碗中场秀4K: 蕾哈娜超级碗中场秀4K
霍格沃茨之遗Steam销量碾压: 霍格沃茨之遗Steam销量碾压
陈翔六点半 同患难不共富贵: 陈翔六点半 同患难不共富贵
和高启强谈恋爱是什么体验: 和高启强谈恋爱是什么体验