流浪地球2这是能吐槽的吗: 流浪地球2这是能吐槽的吗
流浪地球2英国首映评论: 流浪地球2英国首映评论
Doinb: Doinb
女生拒绝相亲被围着做思想工作: 女生拒绝相亲被围着做思想工作
流浪地球2对中国电影的意义: 流浪地球2对中国电影的意义
杨迪 这次分手和离婚无异: 杨迪 这次分手和离婚无异
狂飙刀哥居然是卧底: 狂飙刀哥居然是卧底
Theshy Crisp: Theshy和Crisp是在拍连续剧吗
零下30度把iPhone冰冻48小时: 零下30度把iPhone冰冻48小时
西南大学通报教授与博士生关系不当: 西南大学通报教授与博士生关系不当
专家称四川泸定地震为去年余震: 专家称四川泸定地震为去年余震
男子存钱时发现满地红包: 男子存钱时发现满地红包
原味大肠顶级厨师愈涛最新回应: 原味大肠顶级厨师愈涛最新回应
绝地求生自己捡的雷自己吃: 绝地求生自己捡的雷自己吃
广化寺晚上闭门游客踹门而入: 广化寺晚上闭门游客踹门而入
官方回应游客打架致三星堆文物翻倒: 官方回应游客打架致三星堆文物翻倒
官方回应西安回民街6根面20元: 官方回应西安回民街6根面20元
深海值得被更多人知道: 深海值得被更多人知道
icon妈妈 不要在网上吵架了: icon妈妈 不要在网上吵架了
曼珠沙华是最弱的暗影刺客吗: 曼珠沙华是最弱的暗影刺客吗
梅西 给你俩窝窝: 梅西 给你俩窝窝获传播类大奖
BLACKPINK法国第一夫人慈善宴舞台: BLACKPINK法国第一夫人慈善宴舞台
米将军谈崩坏星穹铁道: 米将军谈崩坏星穹铁道
史上最聪明僵尸: 史上最聪明僵尸
星穹铁道快速入坑攻略: 星穹铁道快速入坑攻略
军港封锁区实现全装自由方法: 军港封锁区实现全装自由方法
有猫病: 有猫病
狂飙剧组的盒饭是啥样: 狂飙剧组的盒饭是啥样
JENNIE最新solo曲编舞花絮: JENNIE最新solo曲编舞花絮
平遥清代首富的大宅院: 平遥清代首富的大宅院