曼珠沙华是最弱的暗影刺客吗: 曼珠沙华是最弱的暗影刺客吗
高考700分过年啥体验: 高考700分过年啥体验
icon妈妈 不要在网上吵架了: icon妈妈 不要在网上吵架了
女生拒绝相亲被围着做思想工作: 女生拒绝相亲被围着做思想工作
现在谁还玩原版泰拉啊: 现在谁还玩原版泰拉啊
悬疑喜剧唐人街探案解说: 悬疑喜剧唐人街探案解说
官方回应西安回民街6根面20元: 官方回应西安回民街6根面20元
杨迪 这次分手和离婚无异: 杨迪 这次分手和离婚无异
挑战用芭芭拉打死纯水: 挑战用芭芭拉打死纯水
内娱舞台也有疯批帅哥了: 内娱舞台也有疯批帅哥了
熊大熊二不是妈妈生的吗: 熊大熊二不是妈妈生的吗
官方回应游客打架致三星堆文物翻倒: 官方回应游客打架致三星堆文物翻倒
专家称四川泸定地震为去年余震: 专家称四川泸定地震为去年余震
西南大学通报教授与博士生关系不当: 西南大学通报教授与博士生关系不当
香港籍货轮6名中国船员遇难: 香港籍货轮6名中国船员遇难
为给红包被撕坏一万多块羽绒服: 为给红包被撕坏一万多块羽绒服
邓稼先嘴角未擦干的血迹: 邓稼先嘴角未擦干的血迹
行尸走肉看多了的后遗症: 行尸走肉看多了的后遗症
中国科幻片都这么猛了吗: 中国科幻片都这么猛了吗
一句话回怼道德绑架: 一句话回怼道德绑架动物版
TF家族练习生舞台纯享版: TF家族练习生舞台纯享版
当二哈看到我假装掉地上的肉: 当二哈看到我假装掉地上的肉
流浪地球2的黑科技耳机: 流浪地球2的黑科技耳机如何设计
零下30度把iPhone冰冻48小时: 零下30度把iPhone冰冻48小时
全国统一的过年穿搭: 全国统一的过年穿搭
男子过年看电影买到无座票: 男子过年看电影买到无座票
军港封锁区实现全装自由方法: 军港封锁区实现全装自由方法
杨迪发文回应分手: 杨迪发文回应分手
吃顶级大肠替身觉醒的评委: 吃顶级大肠替身觉醒的评委
关于我的存在让别人焦虑: 关于我的存在让别人焦虑