习近平当选中华人民共和国主席: 习近平当选中华人民共和国主席
习近平当选中央军委主席: 习近平当选中央军委主席
宪法宣誓: 宪法宣誓
研考国家线发布: 研考国家线发布
FPX OMG: FPX OMG
新一届国家领导人选举产生: 新一届国家领导人选举产生
妲己九尾狐新皮肤特效: 妲己九尾狐新皮肤特效
Uzi带飞战鹰: Uzi带飞战鹰
GTA线上最后一剂预告片: GTA线上最后一剂预告片
汪峰: 汪峰评价爱如火
阳光彩虹大司马: 阳光彩虹大司马
元龙宋嫣超还原COS: 元龙宋嫣超还原COS
吉尔吉斯斯坦逆天乌龙球: 吉尔吉斯斯坦逆天乌龙球
非洲抽象蜘蛛侠: 非洲抽象蜘蛛侠
洛克王国反伤有多强: 洛克王国反伤有多强
S8.5第1个8万血的剑魔: S8.5第1个8万血的剑魔
试玩男性向恋爱游戏: 试玩男性向恋爱游戏
Epic周免 海之呼唤: Epic周免 海之呼唤
果赖: 果赖
李宏伟扮演者阿如那: 李宏伟扮演者阿如那来了
LPL十大选手投票: LPL十大选手投票
方舟怪猎联动好还原: 方舟怪猎联动好还原
玩4天LOL送绝息圣堂洛: 玩4天LOL送绝息圣堂洛
mirror2开发组宣布破产: mirror2开发组宣布破产
高启盛的疯狂复仇: 高启盛的疯狂复仇
5秒速开椰子的小机关: 5秒速开椰子的小机关
这才是想要的浏览器: 这才是想要的浏览器
中国队本届首支本垒打: 中国队本届首支本垒打
堡垒之夜联动巨人: 堡垒之夜联动巨人
4个召唤物击杀永劫龙兽: 4个召唤物击杀永劫龙兽