侯翠翠 拿了百大不装了: 侯翠翠 拿了百大不装了
JDG BLG: JDG 2-1 BLG
rookie说theshy想解封要写申请: rookie说theshy想解封要写申请
俄称不对中国旅客额外设限: 俄称不对中国旅客额外设限
韩男团成员称韩国历史好似短篇小说: 韩男团成员称韩国历史好似短篇小说
Doinb 在线求职: Doinb 在线求职
网易暴雪运营员工大部分已离职: 网易暴雪运营员工大部分已离职
苹果CEO库克主动要求降薪: 苹果CEO库克主动要求降薪
如果在十八: 如果在十八我没能忽悠他
战鹰的厨房初体验: 战鹰的厨房初体验
省教育厅回应女生宿舍坠亡: 省教育厅回应女生宿舍坠亡
ZC领奖把衣服脱了: ZC领奖把衣服脱了
女子亲人去世请假遭老板怼: 女子亲人去世请假遭老板怼
熊二: 熊二要来B站直播了
金州勇士队总冠军戒指开箱: 金州勇士队总冠军戒指开箱
文明6新增中国领袖: 文明6新增中国领袖
想被王思聪打这个梗很丑陋: 想被王思聪打这个梗很丑陋
韩国官员诚挚欢迎中国游客: 韩国官员诚挚欢迎中国游客
籽岷团队对籽岷领奖的反应: 籽岷团队对籽岷领奖的反应
LOL2v2v2v2新模式曝光: LOL2v2v2v2新模式曝光
微信新版本特性: 微信新版本特性有多离谱
无论几岁女生万岁: 无论几岁女生万岁
马思唯易梦玲疑似分手: 马思唯易梦玲疑似分手
真实版肖申克的救赎: 真实版肖申克的救赎
百大UP主获奖感言第4弹: 百大UP主获奖感言第4弹
央视boys: 央视boys合体演唱跟着我念字正腔圆
KFC可达鸭新春回归: KFC可达鸭新春回归
央视网络春晚节目单: 央视网络春晚节目单
深海大圣归来联动短片: 深海大圣归来联动短片
红警HBK08百大获奖感言: 红警HBK08百大获奖感言