网易暴雪运营员工大部分已离职: 网易暴雪运营员工大部分已离职
侃爷失踪一个月重磅回归: 侃爷失踪一个月重磅回归
老番茄 我想养个这玩意儿: 老番茄 我想养个这玩意儿
俄称不对中国旅客额外设限: 俄称不对中国旅客额外设限
去世爷爷手机每页都空出孙子的脸: 去世爷爷手机每页都空出孙子的脸
想被王思聪打这个梗很丑陋: 想被王思聪打这个梗很丑陋
LOL2v2v2v2新模式曝光: LOL2v2v2v2新模式曝光
国际足联调查阿根廷队世界杯不当行为: 国际足联调查阿根廷队世界杯不当行为
AL iG: AL iG
韩男团成员称韩国历史好似短篇小说: 韩男团成员称韩国历史好似短篇小说
阳完了: 阳完了
如果在十八: 如果在十八我没能忽悠他
Doinb和FoFo同时发问阿乐: Doinb和FoFo同时发问阿乐
韩国官员诚挚欢迎中国游客: 韩国官员诚挚欢迎中国游客
ZC领奖把衣服脱了: ZC领奖把衣服脱了
熊二: 熊二要来B站直播了
rookie说theshy想解封要写申请: rookie说theshy想解封要写申请
FPX WE: FPX 1-2 WE
第五人格幸运儿拉塔托斯克: 第五人格幸运儿拉塔托斯克
王一博说想不到会出演无名: 王一博说想不到会出演无名
苏炳添当选中国田协副主席: 苏炳添当选中国田协副主席
汉武帝怎么站着把钱挣了: 汉武帝怎么站着把钱挣了
省教育厅回应女生宿舍坠亡: 省教育厅回应女生宿舍坠亡
刘心悠承认已婚: 刘心悠承认已婚
中国奇谭是做给大人的动画吗: 中国奇谭是做给大人的动画吗
伊藤润二狂热 日本恐怖故事预告: 伊藤润二狂热 日本恐怖故事预告
王师傅排5小时吃的火锅: 王师傅排5小时吃的火锅
籽岷团队对籽岷领奖的反应: 籽岷团队对籽岷领奖的反应
华为新款芯片曝光: 华为新款芯片曝光
农民工1人占6个行李架位被怼: 农民工1人占6个行李架位被怼