横扫日本10亿票房的中国球王: 横扫日本10亿票房的中国球王
外国人看高启强砸头名场面: 外国人看高启强砸头名场面
yoyo颢鑫官宣恋情: yoyo颢鑫官宣恋情
女儿失联3天父亲仍敲打废墟呼唤: 女儿失联3天父亲仍敲打废墟呼唤
清华教授为村民3D打印住宅: 清华教授为村民3D打印住宅
TES UP: TES UP
官方回应网民称水浒应从课文清除: 官方回应网民称水浒应从课文清除
C罗职业生涯第11次大四喜: C罗职业生涯第11次大四喜
土耳其强震遇难人数已超日本大地震: 土耳其强震遇难人数已超日本大地震
男孩7次举手后身亡案二审: 男孩7次举手后身亡案二审
用流浪地球方式打开原神: 用流浪地球方式打开原神
LOL阿狸: LOL阿狸美术更新皮肤展示
Epic下周送小兵大战: Epic下周送小兵大战
中国造的电站在强震中完好无损: 中国造的电站在强震中完好无损
狂飙高启兰火爆日韩: 狂飙高启兰火爆日韩
麦当劳穷鬼新品绝代双椒香骨鸡: 麦当劳穷鬼新品绝代双椒香骨鸡
当年希腊士兵竟能在战场喝咖啡: 当年希腊士兵竟能在战场喝咖啡
英雄联盟台服锁IP: 英雄联盟台服锁IP
韩明起恢复发放中国公民短期签证: 韩明起恢复发放中国公民短期签证
EXO和BTS对家变同事: EXO和BTS对家变同事
小虎韩服遇到新版龙王: 小虎韩服遇到新版龙王
唐小强在华期间多次见义勇为: 唐小强在华期间多次见义勇为
德国实习这么离谱的吗: 德国实习这么离谱的吗
最接地气的小卖部: 最接地气的小卖部
太平洋海面上漂着3.2吨毒品: 太平洋海面上漂着3.2吨毒品
速冻水饺差在哪了: 速冻水饺差在哪了
难怪导演要让她们俩演亲姐妹: 难怪导演要让她们俩演亲姐妹
Apex复仇女神实机上手: Apex复仇女神实机上手
吃鸡更新后能遇见熊了: 吃鸡更新后能遇见熊了
土耳其市民哽咽迎接中国救援队: 土耳其市民哽咽迎接中国救援队