横扫日本10亿票房的中国球王: 横扫日本10亿票房的中国球王
Viper三杀起飞碾压三倍输出: Viper三杀起飞碾压三倍输出
最短命的网红小吃: 最短命的网红小吃
女儿失联3天父亲仍敲打废墟呼唤: 女儿失联3天父亲仍敲打废墟呼唤
男孩7次举手后身亡案二审: 男孩7次举手后身亡案二审
外国人看高启强砸头名场面: 外国人看高启强砸头名场面
土耳其市民哽咽迎接中国救援队: 土耳其市民哽咽迎接中国救援队
DK全员发疯离谱配合看傻眼: DK全员发疯离谱配合看傻眼
迪士尼将制作疯狂动物城2: 迪士尼将制作疯狂动物城2
无期迷途 堇新皮肤: 无期迷途 堇新皮肤
唐小强在华期间多次见义勇为: 唐小强在华期间多次见义勇为
京海中学: 京海中学莽班
QQ首位用户找到了: QQ首位用户找到了
Doinb说今年的LCK可能更恐怖: Doinb说今年的LCK可能更恐怖
大连反向抹零饭店被罚4500元: 大连反向抹零饭店被罚4500元
动视暴雪指责索尼不接电话: 动视暴雪指责索尼不接电话
女子出车祸想用父亲顶包: 女子出车祸想用父亲顶包
吃鸡更新后能遇见熊了: 吃鸡更新后能遇见熊了
功绩社会中看胡某宇之死: 功绩社会中看胡某宇之死
清华教授为村民3D打印住宅: 清华教授为村民3D打印住宅
官方回应网民称水浒应从课文清除: 官方回应网民称水浒应从课文清除
王者新英雄姬小满技能展示: 王者新英雄姬小满技能展示
王者万象棋: 王者万象棋版号获批
宇航员泽拉斯皮肤原画曝光: 宇航员泽拉斯皮肤原画曝光
加碘食盐还要不要吃: 加碘食盐还要不要吃
土耳其地震中猫咪和狗狗相互依偎: 土耳其地震中猫咪和狗狗相互依偎
张朝阳再谈四小时睡眠法: 张朝阳再谈四小时睡眠法
正义联盟 RWBY: 正义联盟联动RWBY电影预告
和她相似长相的演员都火了: 和她相似长相的演员都火了
狂飙剧情原来改了这么多: 狂飙剧情原来改了这么多