唐小强确认遇难: 唐小强确认遇难
迪士尼将制作疯狂动物城2: 迪士尼将制作疯狂动物城2
ChatGPT被国足和狂飙问到知识盲区: ChatGPT被国足和狂飙问到知识盲区
QQ首位用户找到了: QQ首位用户找到了
央视网评年轻人越来越反感专家: 央视网评年轻人越来越反感专家
杨迪等非正嘉宾悼念唐小强: 杨迪等非正嘉宾悼念唐小强
Doinb说今年的LCK可能更恐怖: Doinb说今年的LCK可能更恐怖
中国造的电站在强震中完好无损: 中国造的电站在强震中完好无损
非正式会谈: 非正式会谈
勇士队省下3700万: 勇士队省下3700万
韩明起恢复发放中国公民短期签证: 韩明起恢复发放中国公民短期签证
DK全员发疯离谱配合看傻眼: DK全员发疯离谱配合看傻眼
麦当劳穷鬼新品绝代双椒香骨鸡: 麦当劳穷鬼新品绝代双椒香骨鸡
当年希腊士兵竟能在战场喝咖啡: 当年希腊士兵竟能在战场喝咖啡
新疆禁毒形象大使不像演的: 新疆禁毒形象大使不像演的
13岁女孩4.82秒打破鲁班锁世界纪录: 13岁女孩4.82秒打破鲁班锁世界纪录
还没阳过的孩子老人再感染可能性小: 还没阳过的孩子老人再感染可能性小
张朝阳再谈四小时睡眠法: 张朝阳再谈四小时睡眠法
唐小强在华期间多次见义勇为: 唐小强在华期间多次见义勇为
LOL阿狸: LOL阿狸美术更新皮肤展示
韩娱四大公司或将成为历史: 韩娱四大公司或将成为历史
宇航员泽拉斯皮肤原画曝光: 宇航员泽拉斯皮肤原画曝光
男人为了买霍格沃兹能付出多大代价: 男人为了买霍格沃兹能付出多大代价
原神弹刀活动的正确玩法: 原神弹刀活动的正确玩法
永劫新英雄胡为携斩马刀登场: 永劫新英雄胡为携斩马刀登场
星穹铁道新角色白露: 星穹铁道新角色白露
银河奖作品 死在火星上: 银河奖作品 死在火星上
德华遇到粉丝揭短自己借号: 德华遇到粉丝揭短自己借号
韩国科幻灾难电影 贞伊: 韩国科幻灾难电影 贞伊
C罗上演大四喜: C罗上演大四喜