横扫日本10亿票房的中国球王: 横扫日本10亿票房的中国球王
清华教授为村民3D打印住宅: 清华教授为村民3D打印住宅
QQ首位用户找到了: QQ首位用户找到了
女儿失联3天父亲仍敲打废墟呼唤: 女儿失联3天父亲仍敲打废墟呼唤
流浪地球2图丫丫房间解析: 流浪地球2图丫丫房间解析
土耳其市民哽咽迎接中国救援队: 土耳其市民哽咽迎接中国救援队
TES UP: TES UP
粉丝自制视频纪念唐小强: 粉丝自制视频纪念唐小强
官方回应网民称水浒应从课文清除: 官方回应网民称水浒应从课文清除
CSGO变革武器箱皮肤: CSGO变革武器箱皮肤
男孩7次举手后身亡案二审: 男孩7次举手后身亡案二审
迪士尼将制作疯狂动物城2: 迪士尼将制作疯狂动物城2
凤凰传奇献唱黎明觉醒: 凤凰传奇献唱黎明觉醒生机
1分钟告诉你ChatGPT是什么: 1分钟告诉你ChatGPT是什么
韩明起恢复发放中国公民短期签证: 韩明起恢复发放中国公民短期签证
垚组合再也聚不齐了: 非正 垚组合再也聚不齐了
非正式会谈发文悼念唐小强: 非正式会谈发文悼念唐小强
项羽新皮肤值不值得买: 项羽新皮肤值不值得买
狂飙结局高启强只能算惨胜: 狂飙结局高启强只能算惨胜
新疆禁毒形象大使不像演的: 新疆禁毒形象大使不像演的
HYBE宣布参与收购SMTOWN: HYBE宣布参与收购SMTOWN
篮网彻底摧毁西部联盟: 篮网彻底摧毁西部联盟
唐小强在华期间多次见义勇为: 唐小强在华期间多次见义勇为
流浪地球2洛杉矶口碑特辑: 流浪地球2洛杉矶口碑特辑
ChatGPT被国足和狂飙问到知识盲区: ChatGPT被国足和狂飙问到知识盲区
ChatGPT的致命弱点: ChatGPT的致命弱点
太平洋海面上漂着3.2吨毒品: 太平洋海面上漂着3.2吨毒品
乱飙: 乱飙
洛克王国海芙约忒实战: 洛克王国海芙约忒实战
APEX新武器复仇女神: APEX新武器复仇女神