诺奖得主称宇宙在循环: 诺奖得主称宇宙在循环
海贼王双生果实公布: 海贼王双生果实公布
高考誓师校长带学生解压: 高考誓师校长带学生解压
赵志铭被踢出解说名单: 赵志铭被踢出解说名单
实拍沉浸式捐精全过程: 实拍沉浸式捐精全过程
量子少年两名成员休眠: 量子少年两名成员休眠
高三女孩脱稿演讲燃爆全场: 高三女孩脱稿演讲燃爆全场
R星出品 必属只因品: R星出品 必属只因品
谭sir拦截卖鱼兄弟: 谭sir拦截卖鱼兄弟
赛尔号草系之王依依: 赛尔号草系之王依依
唐仁杰探店苍蝇馆子: 唐仁杰探店苍蝇馆子
10000倍速看完柯南: 10000倍速看完柯南
狂飙全剧最窒息饭局: 狂飙全剧最窒息饭局
原神动画 晴天雨露: 原神动画 晴天雨露
代表建议提前高考: 代表建议提前高考
代表对未成年网游的建议: 代表对未成年网游的建议
梅西拒绝降薪续约: 梅西拒绝降薪续约
E.T.外星人: E.T.外星人上线B站
柯洁视角胜李轩豪: 柯洁视角胜李轩豪
LOL猫咪重做后更强了: LOL猫咪重做后更强了
八重神子cos化妆教程: 八重神子cos化妆教程
卡维动态立绘展示: 卡维动态立绘展示
迪希雅的美妆小课堂: 迪希雅的美妆小课堂
森林之子未实装内容: 森林之子未实装内容
Dota2冰蛙: Dota2冰蛙
PDD试玩卧龙苍天陨落: PDD试玩卧龙苍天陨落
C罗带队逆转绝地求生: C罗带队逆转绝地求生
朋友cos瑶瑶来接机: 朋友cos瑶瑶来接机
无证教练法甲不败: 无证教练法甲不败
真探唐仁杰赶河南庙会: 真探唐仁杰赶河南庙会