Letme谈被压400刀: Letme谈被压400刀
必胜客联动原神: 必胜客联动原神
周星驰最被低估之作: 周星驰最被低估之作
乌梅子酱其实不存在: 乌梅子酱其实不存在
感染甲流大部分都是轻症: 感染甲流大部分都是轻症
伊藤润二辟谣对联动不满: 伊藤润二辟谣对联动不满
被严重低估的神作: 被严重低估的神作
机械革命旷世16super: 机械革命旷世16super
ChatGPT给出的LPL最佳阵容: ChatGPT给出的LPL最佳阵容
第五人格返场消息: 第五人格返场消息
WBG酒桶薇恩奇招: WBG酒桶薇恩奇招
乾隆巅峰战到底有多难: 乾隆巅峰战到底有多难
小智将回归朱紫剧情: 小智将回归朱紫剧情
中美薯片差异这么大: 中美薯片差异这么大
盘古B叔11000亿伤害: 盘古B叔11000亿伤害
AOV一拳超人死神联动: AOV一拳超人死神联动
大学生用共享位置捉迷藏: 大学生用共享位置捉迷藏
大熊猫乐乐死因初步确定: 大熊猫乐乐死因初步确定
本来挺喜欢漫展的: 本来挺喜欢漫展的
装修为什么要去客厅化: 装修为什么要去客厅化
泰拉瑞亚开发者逝世: 泰拉瑞亚开发者逝世
诺基亚更换新logo: 诺基亚更换新logo
成年人的崩溃只在一瞬间: 成年人的崩溃只在一瞬间
一口气搞清楚ChatGPT: 一口气搞清楚ChatGPT
不想挣钱谁住城中村: 不想挣钱谁住城中村
宝可梦拉普拉斯回归: 宝可梦拉普拉斯回归
自制崩坏星穹铁道沙画: 自制崩坏星穹铁道沙画
猫和老鼠西部大冒险: 猫和老鼠西部大冒险
警犬 有人抢我们的饭碗: 警犬 有人抢我们的饭碗
四川发生非煤矿山顶板事故: 四川发生非煤矿山顶板事故