CSGO成steam历史在线第二: CSGO成steam历史在线第二
香港首次成中国男篮主场: 香港首次成中国男篮主场
王者伤害负数对面回血吗: 王者伤害负数对面回血吗
不小心抠掉了小猫的捏捏头: 不小心抠掉了小猫的捏捏头
羊飙: 羊飙
上海50一个的奶油面包: 上海50一个的奶油面包
爸爸带儿子玩真人版扫雷: 爸爸带儿子玩真人版扫雷
抗日神剧惊现刺客信条: 抗日神剧惊现刺客信条
SpaceX因故取消发射: SpaceX因故取消发射
森林之子怎么让凯文建房子: 森林之子怎么让凯文建房子
罗翔评七号房的礼物: 罗翔评七号房的礼物
原神 阳光开朗小女孩: 原神 阳光开朗小女孩
为何很多人不愿办ETC: 为何很多人不愿办ETC
一加11水冷概念手机: 一加11水冷概念手机
怎么你们都是律者: 怎么你们都是律者
甘孜文旅局长回应网友投诉: 甘孜文旅局长回应网友投诉
狂飙麻子变成景点了: 狂飙麻子变成景点了
必胜客联动原神: 必胜客联动原神
大学生在玩一种新的信任: 大学生在玩一种新的信任
日本机关食堂吃挂壁饭: 日本机关食堂吃挂壁饭
感染甲流大部分都是轻症: 感染甲流大部分都是轻症
UP海上偶遇中国海军编队: UP海上偶遇中国海军编队
宝可梦朱紫DLC公开: 宝可梦朱紫DLC公开
全球AI竞赛抢显卡: 全球AI竞赛抢显卡
猫猫有种脑干缺失的美: 猫猫有种脑干缺失的美
梅西为何是世界足球先生: 梅西为何是世界足球先生
陈翔六点半更新: 陈翔六点半更新
著名经济学家厉以宁逝世: 著名经济学家厉以宁逝世
小栗旬俏佳人给消防剪头: 小栗旬俏佳人给消防剪头
保卫萝卜4无伤73令牌: 保卫萝卜4无伤73令牌