诺奖得主称宇宙在循环: 诺奖得主称宇宙在循环
今年最逆天的神剧: 今年最逆天的神剧
冥河水母现身南极深海: 冥河水母现身南极深海
建议推行婚检与婚姻登记一站式服务: 建议推行婚检与婚姻登记一站式服务
赵志铭被踢出解说名单: 赵志铭被踢出解说名单
高三女孩脱稿演讲燃爆全场: 高三女孩脱稿演讲燃爆全场
球2在中国空间站上映: 球2在中国空间站上映
2023年GDP目标为增长5%左右: 2023年GDP目标为增长5%左右
FNC加时翻盘夺冠: FNC加时翻盘夺冠
量子少年两名成员休眠: 量子少年两名成员休眠
实拍沉浸式捐精全过程: 实拍沉浸式捐精全过程
取消动物表演的动物园: 取消动物表演的动物园
明日方舟苔生兽: 明日方舟苔生兽
唐仁杰探店苍蝇馆子: 唐仁杰探店苍蝇馆子
拍了15季的电视剧: 拍了15季的电视剧
AI修复雷锋生前影像: AI修复雷锋生前影像
进击的巨人空降神曲: 进击的巨人空降神曲
首师大校长聊ChatGPT: 首师大校长聊ChatGPT
三体全书最重要的一刻: 三体全书最重要的一刻
Steam五款史低游戏: Steam五款史低游戏
崩坏3新地图展示: 崩坏3新地图展示
全球最长寿风暴将登场: 全球最长寿风暴将登场
R星出品 必属只因品: R星出品 必属只因品
孙策的被动护甲: 孙策的被动护甲
海贼王双生果实公布: 海贼王双生果实公布
韩立出手了: 韩立出手了
自制忏悔辅助器: 自制忏悔辅助器
假面骑士极狐: 假面骑士极狐B站开播
代表建议提前高考: 代表建议提前高考
游戏卧龙和只狼的不同: 游戏卧龙和只狼的不同