谁说中国人拍不出科幻片: 谁说中国人拍不出科幻片
暴雪更改魔兽除夕夜活动时间: 暴雪更改魔兽除夕夜活动时间
LOL狮子狗和螳螂彩蛋回归: LOL狮子狗和螳螂彩蛋回归
刘畊宏活过一百岁健身操: 刘畊宏活过一百岁健身操
中国女子在泰国预订到警车接机: 中国女子在泰国预订到警车接机
Kiin贾克斯上路单杀DnDn: Kiin贾克斯上路单杀DnDn
王者当攻速负到极致会怎样: 王者当攻速负到极致会怎样
火影青水开局8秒无敌: 火影青水开局8秒无敌
XDD逮住司机自卖自夸: XDD逮住司机自卖自夸
Jennie芭蕾风穿搭: Jennie芭蕾风穿搭
日本11.6万人在线看春晚: 日本11.6万人在线看春晚
张大仙抽到了6颗荣耀水晶: 张大仙抽到了6颗荣耀水晶
给垃圾房的大爷大妈准备年夜饭: 给垃圾房的大爷大妈准备年夜饭
满江红含腾量超高: 满江红含腾量超高
女子坚持每年春节看望救命恩人: 女子坚持每年春节看望救命恩人
县城过年现状: 县城过年现状
告别暴雪游戏国服账号: 告别暴雪游戏国服账号
流浪地球2首日票房破三亿: 流浪地球2首日票房破三亿
靠抢才能吃的川菜: 靠抢才能吃的川菜
蔡明 刘谦: 蔡明当托把刘谦整崩溃了
HLE不敌LSB: HLE不敌LSB
Steam新年特卖史低游戏: Steam新年特卖史低游戏
满江红: 满江红估计要炸
马丽称上台时鞋跟意外断掉: 马丽称上台时鞋跟意外断掉
越南正在过猫年: 越南正在过猫年
王者十大上分战神: 王者十大上分战神
哈兰德第4次帽子戏法: 哈兰德第4次帽子戏法
小兔糕市集: 小兔糕市集
明日之后联动流浪地球2: 明日之后联动流浪地球2
女朋友准备的过年三件套: 女朋友准备的过年三件套