国家主席习近平发表重要讲话: 国家主席习近平发表重要讲话
人民的信任是我前进的最大动力: 人民的信任是我前进的最大动力
坚定不移推进祖国统一进程: 坚定不移推进祖国统一进程
WBG OMG: WBG战胜OMG
黄河历史上第44次变清: 黄河历史上第44次变清
UP问曹可凡知道B站吗: UP问曹可凡知道B站吗
美国公示丫丫回国相关申请: 美国公示丫丫回国相关申请
李强答中外记者问: 李强答中外记者问
中国棒球vs韩国: 中国棒球vs韩国
NASA 2046年可能行星撞地球: NASA 2046年可能行星撞地球
电棍宣布退役: 电棍在饭堂宣布退役
单身女性冻卵或将不再是梦: 单身女性冻卵或将不再是梦
藏在火锅底料里的生意: 藏在火锅底料里的生意
影史首位华裔奥斯卡影后: 影史首位华裔奥斯卡影后
我国人口红利并没有消失: 我国人口红利并没有消失
龙与地下城国外口碑炸裂: 龙与地下城国外口碑炸裂
手机摄像头或在监视你: 手机摄像头或在监视你
多人间谍游戏欺骗公司: 多人间谍游戏欺骗公司
日本将翻拍隐秘的角落: 日本将翻拍隐秘的角落
水晶宫球迷怀念范志毅: 水晶宫球迷怀念范志毅
LCK团结大会打野篇: LCK团结大会打野篇
Angel回应给WBG亮弱爆: Angel回应给WBG亮弱爆
重启人生大结局: 重启人生大结局
成龙开启警匪片大时代: 成龙开启警匪片大时代
英国母子狂飙Reaction: 英国母子狂飙Reaction
硅谷银行破产: 硅谷银行破产
陈梦2比3萨马拉: 陈梦2比3萨马拉
蕾哈娜奥斯卡表演现场: 蕾哈娜奥斯卡表演现场
杨紫琼获得奥斯卡影后: 杨紫琼获得奥斯卡影后
WBG失利原因: WBG失利原因