国家主席习近平发表重要讲话: 国家主席习近平发表重要讲话
人民的信任是我前进的最大动力: 人民的信任是我前进的最大动力
坚定不移推进祖国统一进程: 坚定不移推进祖国统一进程
李强答中外记者问: 李强答中外记者问
我国人口红利并没有消失: 我国人口红利并没有消失
杨紫琼获得奥斯卡影后: 杨紫琼获得奥斯卡影后
瞬息全宇宙获最佳影片: 瞬息全宇宙获最佳影片
新疆司机婉拒乘客多付款: 新疆司机婉拒乘客多付款
瞬息全宇宙横扫奥斯卡: 瞬息全宇宙横扫奥斯卡
大熊猫的生存哲学: 大熊猫的生存哲学
LOL猫蟹组合称霸下路: LOL猫蟹组合称霸下路
教授谈为何手机会越用越慢: 教授谈为何手机会越用越慢
藏在火锅底料里的生意: 藏在火锅底料里的生意
宝可梦火箭队要解散吗: 宝可梦火箭队要解散吗
多人间谍游戏欺骗公司: 多人间谍游戏欺骗公司
龙与地下城国外口碑炸裂: 龙与地下城国外口碑炸裂
手机摄像头或在监视你: 手机摄像头或在监视你
周深新海诚梦幻合作: 周深新海诚梦幻合作
小钰问Meiko拉二胡技巧: 小钰问Meiko拉二胡技巧
2023奥斯卡获奖名单: 2023奥斯卡获奖名单
水晶宫球迷怀念范志毅: 水晶宫球迷怀念范志毅
这个忍者超强却过分慎重: 这个忍者超强却过分慎重
硅谷银行破产: 硅谷银行破产
9元的即食汉堡好吃吗: 9元的即食汉堡好吃吗
TES主教练暂离赛场: TES主教练暂离赛场
妍珍在监狱里播报天气: 妍珍在监狱里播报天气
暗黑破坏神4将免费公测: 暗黑破坏神4将免费公测
楚均复盘WBG奇怪BP: 楚均复盘WBG奇怪BP
开心超人联盟最新PV: 开心超人联盟最新PV
U20国足打光最后一颗子弹: U20国足打光最后一颗子弹