暴雪关服了才发现只感动了自己: 暴雪关服了才发现只感动了自己
原神为什么刻晴卷不过新激化C: 原神为什么刻晴卷不过新激化C
洛克王国手游九只新宠物爆料: 洛克王国手游九只新宠物爆料
为什么不建议大家冲动养狗: 为什么不建议大家冲动养狗
花少北强行寄生在朋友家一周: 花少北强行寄生在朋友家一周
张艺谋曾设想满江红全片一镜到底: 张艺谋曾设想满江红全片一镜到底
原神主播是怎么亏破产的: 原神主播是怎么亏破产的
流浪地球2 沙溢杀青了多少回: 流浪地球2 沙溢杀青了多少回
觉醒之战最强英雄排行榜: 觉醒之战最强英雄排行榜
西安市民喊话把景点让给外地游客: 西安市民喊话把景点让给外地游客
把优菈变成能外穿的衣服: 把优菈变成能外穿的衣服
警方回应山东一轿车贴日本军旗: 警方回应山东一轿车贴日本军旗
222个账号因炫耀服刑等被处置: 222个账号因炫耀服刑等被处置
喝不上酒的交警女婿开始上班了: 喝不上酒的交警女婿开始上班了
妈妈不小心拨到已故外公的电话: 妈妈不小心拨到已故外公的电话
流浪地球2联合国大厅: 流浪地球2复刻联合国大厅
中国技术被印在外国纸币上: 中国技术被印在外国纸币上
当红警被对手说太专业了: 当红警被对手说太专业了
原神流光拾遗之旅仙闻篇: 原神流光拾遗之旅仙闻篇
大司马 口技: 大司马 口技
崩斯卡最佳女配空之律者: 崩斯卡最佳女配空之律者
孙悟空新皮肤值得买吗: 孙悟空新皮肤值得买吗
地下停车场停汗血宝马: 地下停车场停汗血宝马
TheShy狗头900层被动: TheShy狗头900层被动
地球不能没有修狗: 地球不能没有修狗
S30国一吕布全顶尖出装: S30国一吕布全顶尖出装
罗纳尔多 外星人: 罗纳尔多为什么外号外星人
大娘放加特林烟花如上战场: 大娘放加特林烟花如上战场
女子举报前国足球员婚内出轨: 女子举报前国足球员婚内出轨
同小区同位置三次猫咪被困: 同小区同位置三次猫咪被困