ChatGPT给出的LPL最佳阵容: ChatGPT给出的LPL最佳阵容
大学生用共享位置捉迷藏: 大学生用共享位置捉迷藏
泰拉瑞亚开发者逝世: 泰拉瑞亚开发者逝世
日本一温泉被曝半年不换水: 日本一温泉被曝半年不换水
伊藤润二辟谣对联动不满: 伊藤润二辟谣对联动不满
中美薯片差异这么大: 中美薯片差异这么大
大熊猫乐乐死因初步确定: 大熊猫乐乐死因初步确定
保洁称捡2万元报警被开除: 保洁称捡2万元报警被开除
Uzi科目三没过: Uzi科目三没过
盘古B叔11000亿伤害: 盘古B叔11000亿伤害
16人格在寝室的表现: 16人格在寝室的表现
蜜蜂小狗头肿为绳索勒伤: 蜜蜂小狗头肿为绳索勒伤
爆汁肉馅瑞士卷: 爆汁肉馅瑞士卷
WBG LNG: LNG战胜WBG
四省联考英语七选五解法: 四省联考英语七选五解法
飞越13号房杨校长谈魔兽: 飞越13号房杨校长谈魔兽
卧龙赵云套装获取方法: 卧龙赵云套装获取方法
小米主题的终极形态: 小米主题的终极形态
夜市偶遇张颂文: 夜市偶遇张颂文
成年人的崩溃只在一瞬间: 成年人的崩溃只在一瞬间
小智将回归朱紫剧情: 小智将回归朱紫剧情
一口气搞清楚ChatGPT: 一口气搞清楚ChatGPT
不想挣钱谁住城中村: 不想挣钱谁住城中村
宝可梦拉普拉斯回归: 宝可梦拉普拉斯回归
自制崩坏星穹铁道沙画: 自制崩坏星穹铁道沙画
四川发生非煤矿山顶板事故: 四川发生非煤矿山顶板事故
复刻原神甜甜花酿鸡: 复刻原神甜甜花酿鸡
千万别再乱扔快递盒了: 千万别再乱扔快递盒了
减脂人眼中不长胖酱料: 减脂人眼中不长胖酱料
自制LOL全英雄语音网站: 自制LOL全英雄语音网站