佛山地震: 佛山地震
穿越火线X宣布关服: 穿越火线X宣布关服
TES NIP: TES NIP
王传君 王一博: 王传君称王一博学得很快
逐步将辅助生殖技术纳入医保: 逐步将辅助生殖技术纳入医保
盲人发现iPhone转账语音播报错误: 盲人发现iPhone转账语音播报错误
中美将调查大熊猫乐乐死因: 中美将调查大熊猫乐乐死因
满级高启强屠杀新手村: 满级高启强屠杀新手村
沈腾马丽时隔8年再演夏洛马冬梅: 沈腾马丽时隔8年再演夏洛马冬梅
汤圆和元宵傻傻分不清: 汤圆和元宵傻傻分不清
高分俄剧叶卡捷琳娜二世: 高分俄剧叶卡捷琳娜二世解说
Theshy一打三力挽狂澜: Theshy一打三力挽狂澜
超市回应1个橙子卖128元: 超市回应1个橙子卖128元
各解说看IG不败金身被终结: 各解说看IG不败金身被终结
父亲借女儿3万压岁钱不还被起诉: 父亲借女儿3万压岁钱不还被起诉
德华露娜首秀: 德华露娜首秀
原神 丽莎游记: 原神 丽莎游记
大哥 我给你送了点鱼过来: 大哥 我给你送了点鱼过来
守望先锋或将移除地图池: 守望先锋或将移除地图池
当外国人体验汉服: 当外国人体验汉服
流浪提瓦特: 流浪提瓦特
MC新增13亿件皮革装备: MC新增13亿件皮革装备
曹魏外姓第一大将于禁: 曹魏外姓第一大将于禁
电车难题解决方案分析: 电车难题解决方案分析
徐静雨 勇士为何接连输球: 徐静雨 勇士为何接连输球
年龄焦虑: 面对天才如何避免年龄焦虑
除了原味大肠还有多少惊喜: 除了原味大肠还有多少惊喜
湖南许广高速多车相撞起火: 湖南许广高速多车相撞起火
井上正大逛横滨中华街: 井上正大逛横滨中华街
震撼水墨特效遇上中国戏曲: 震撼水墨特效遇上中国戏曲