听说过年有7亿人来西安: 听说过年有7亿人来西安
流浪地球2北美上映特效受好评: 流浪地球2北美上映特效受好评
熊出没开始走深度路线了: 熊出没开始走深度路线了
满江红票房实现逆跌: 满江红票房实现逆跌
印度收到90亿光年外星系无线电信号: 印度收到90亿光年外星系无线电信号
张艺谋谈放弃满江红一镜到底: 张艺谋谈放弃满江红一镜到底
流浪地球2为什么比1更牛: 流浪地球2为什么比1更牛
日本GDP今年或被德国超越: 日本GDP今年或被德国超越
花木兰联动AOV皮肤预热上线: 花木兰联动AOV皮肤预热上线
原神魈的全新玩法: 原神魈的全新玩法
虚拟区第一ikun: 虚拟区第一ikun
miHoYo冬季周边实物展示: miHoYo冬季周边实物展示
曝梅西决定不与巴黎续约: 曝梅西决定不与巴黎续约
谷歌翻译20遍阿里嘎多美羊羊桑: 谷歌翻译20遍阿里嘎多美羊羊桑
吴京主演电影票房破300亿: 吴京主演电影票房破300亿
韩媒称C罗新年祝福用词不当: 韩媒称C罗新年祝福用词不当
洛克王国手游九只新宠物爆料: 洛克王国手游九只新宠物爆料
九转大肠小胖俞涛的真实生活: 九转大肠小胖俞涛的真实生活
卢卡库 价值3亿的悲伤和快乐: 卢卡库 价值3亿的悲伤和快乐
怎样在游戏里分辨中国狙击手: 怎样在游戏里分辨中国狙击手
伪军围剿鬼畜区: 伪军围剿鬼畜区
在韩逃避隔离中国旅客被驱逐出境: 在韩逃避隔离中国旅客被驱逐出境
觉醒之战最强英雄排行榜: 觉醒之战最强英雄排行榜
还原MC的食物: 还原MC的食物
花少北强行寄生在朋友家一周: 花少北强行寄生在朋友家一周
警方回应山东一轿车贴日本军旗: 警方回应山东一轿车贴日本军旗
同小区同位置三次猫咪被困: 同小区同位置三次猫咪被困
支持百人大战场的免费游戏: 支持百人大战场的免费游戏
炉石UP可以玩原神了: 炉石UP可以玩原神了
有一个戏精女友是什么体验: 有一个戏精女友是什么体验