为给红包被撕坏一万多块羽绒服: 为给红包被撕坏一万多块羽绒服
流浪地球2英国观众观后感: 流浪地球2英国观众观后感
吃顶级大肠替身觉醒的评委: 吃顶级大肠替身觉醒的评委
张艺谋谈放弃满江红一镜到底: 张艺谋谈放弃满江红一镜到底
满江红票房实现逆跌: 满江红票房实现逆跌
梅西计划继续为阿根廷出战: 梅西计划继续为阿根廷出战
一起来看硫酸雨: 一起来看硫酸雨
印度收到90亿光年外星系无线电信号: 印度收到90亿光年外星系无线电信号
春晚导演组邀请UP写小品: 春晚导演组邀请UP写小品
生化危机4重制版: 生化危机4重制版上手前瞻
慢羊羊生日: 慢羊羊生日
纳西妲已经是大人了: 纳西妲已经是大人了
中餐到底怎么才算好吃: 中餐到底怎么才算好吃
曝刘少林刘少昂已入籍中国: 曝刘少林刘少昂已入籍中国
全员马化: 全员马化
天灰灰发布检讨书: 天灰灰发布检讨书
Deft卢锡安: Deft卢锡安不带TP下路完虐
BLACKPINK与法国第一夫人合照: BLACKPINK与法国第一夫人合照
豆瓣8.7分国产悬疑剧迷雾: 豆瓣8.7分国产悬疑剧迷雾
詹姆斯9记三分生涯新高: 詹姆斯9记三分生涯新高
50块装一台能玩LOL的电脑: 50块装一台能玩LOL的电脑
郭帆说拍太空电梯是噩梦: 郭帆说拍太空电梯是噩梦
俄罗斯媳妇体验东北串门年俗: 俄罗斯媳妇体验东北串门年俗
华晨宇 歌迷: 华晨宇的歌迷好会唱
春节档电影联合发倡议书: 春节档电影联合发倡议书
坚如磐石: 坚如磐石发布新贴片预告
第五人格时装补偿再发放: 第五人格时装补偿再发放
康熙怒吃九转大肠: 康熙怒吃九转大肠
大肠赶君: 大肠赶君
柯洁如何看待自己的成功: 柯洁如何看待自己的成功