母女皆是美人的设定没骗人: 母女皆是美人的设定没骗人
高中生用全部积蓄拍战争短片: 高中生用全部积蓄拍战争短片
庄颜还真是战鹰啊: 庄颜还真是战鹰啊
网友吃火锅菜品中发现蓝环章鱼: 网友吃火锅菜品中发现蓝环章鱼
EDG Leave出场化身纳西妲: EDG Leave出场化身纳西妲
网易称暴雪的提议是蛮横的: 网易称暴雪的提议是蛮横的
网易拒绝暴雪顺延6个月提议: 网易拒绝暴雪顺延6个月提议
都什么年代了谁还说传统情话: 都什么年代了谁还说传统情话
众解说看TES四分钟宣布游戏结束: 众解说看TES四分钟宣布游戏结束
我国出生人口下降三大因素: 我国出生人口下降三大因素
KFC可达鸭吸管: KFC可达鸭吸管会唱歌
刘暖曦被采取限制消费: 刘暖曦被采取限制消费
明日方舟回应被抄袭: 明日方舟回应被抄袭
令人瞳孔地震的请假理由: 令人瞳孔地震的请假理由
苹果发布新MacBookPro: 苹果发布新MacBookPro
郑州今年春节可以放烟花了: 郑州今年春节可以放烟花了
姿态看Rookie六分钟打崩对手: 姿态看Rookie六分钟打崩对手
胡鑫宇失踪事件办案民警发声: 胡鑫宇失踪事件办案民警发声
著名武术家及演员于海去世: 著名武术家及演员于海去世
文豪野犬樋口一叶选角确定: 文豪野犬樋口一叶选角确定
汶川地震捐万元的卖炭老人去世: 汶川地震捐万元的卖炭老人去世
给当代年轻人的职场攻略: 给当代年轻人的职场攻略
春晚救场的巅峰之作: 春晚救场的巅峰之作
LOL选人阶段举报功能即将上线: LOL选人阶段举报功能即将上线
服务员将清洁剂当饮料上桌7人误饮: 服务员将清洁剂当饮料上桌7人误饮
HoneyWorks: HoneyWorks来B站了
叶罗丽 看过的都说好: 叶罗丽 看过的都说好
2023年第一批游戏版号公布: 2023年第一批游戏版号公布
老番茄玩The Professional: 老番茄玩The Professional
如果在十八没能把你缉拿: 如果在十八没能把你缉拿