高中生用全部积蓄拍战争短片: 高中生用全部积蓄拍战争短片
网易称暴雪的提议是蛮横的: 网易称暴雪的提议是蛮横的
苹果发布新款MacBookPro: 苹果发布新款MacBookPro
我国出生人口下降三大因素: 我国出生人口下降三大因素
都什么年代了谁还说传统情话: 都什么年代了谁还说传统情话
LOL选人阶段举报功能即将上线: LOL选人阶段举报功能即将上线
如果在十八没能把你缉拿: 如果在十八没能把你缉拿
贾克斯 上单唯一真神: 贾克斯 上单唯一真神
老虎幼崽追大鹅被反杀: 老虎幼崽追大鹅被反杀
米勒管泽元看IG出场整活: 米勒管泽元看IG出场整活
胡鑫宇失踪事件办案民警发声: 胡鑫宇失踪事件办案民警发声
EDG Leave出场化身纳西妲: EDG Leave出场化身纳西妲
暴雪发布国服玩家社区更新说明: 暴雪发布国服玩家社区更新说明
唐探3十字路口有多少人: 唐探3十字路口有多少人
姿态看Rookie六分钟打崩对手: 姿态看Rookie六分钟打崩对手
RNG IG: IG 2-0 RNG
中国男比女多3237万人: 中国男比女多3237万人
张艺谋称满江红首选演员易烊千玺: 张艺谋称满江红首选演员易烊千玺
你会和对象用情头吗: 你会和对象用情头吗
网友吃火锅菜品中发现蓝环章鱼: 网友吃火锅菜品中发现蓝环章鱼
稻妻人幻想: 稻妻人幻想
汶川地震捐万元的卖炭老人去世: 汶川地震捐万元的卖炭老人去世
1999年的中国发生了什么: 1999年的中国发生了什么
众解说看TES四分钟宣布游戏结束: 众解说看TES四分钟宣布游戏结束
网易拒绝暴雪顺延6个月提议: 网易拒绝暴雪顺延6个月提议
漫威电影重回内地上映: 漫威电影重回内地上映
岳云鹏河南春晚打两份工: 岳云鹏河南春晚打两份工
令人瞳孔地震的请假理由: 令人瞳孔地震的请假理由
进击的巨人完结篇预告: 进击的巨人完结篇预告
谁是我的新郎: 谁是我的新郎