暴雪排队退款人数超100万: 暴雪排队退款人数超100万
红烧牛肉味泡面为何永远畅销: 红烧牛肉味泡面为何永远畅销
原神哥锁辅助老鼠两等抓上: 原神哥锁辅助老鼠两等抓上
胡鑫宇尸体发现地系原始第一现场: 胡鑫宇尸体发现地系原始第一现场
谢楠当着吴京的面表白刘德华: 谢楠当着吴京的面表白刘德华
葛优诉葛优躺表情包侵权胜诉: 葛优诉葛优躺表情包侵权胜诉
上海禁止群租: 上海立法禁止群租
雷军称小米对泄密事件零容忍: 雷军称小米对泄密事件零容忍
外国婆婆搜中国攻略搜到儿子: 外国婆婆搜中国攻略搜到儿子
感人故事 大肠移植: 感人故事 大肠移植
原来胡歌当年就自爆过: 原来胡歌当年就自爆过
流浪地球2世界排第几: 流浪地球2世界排第几
吕德华被偷家名场面: 吕德华被偷家名场面
朋友送的星之卡比有多离谱: 朋友送的星之卡比有多离谱
本周Epic喜加一公布: 本周Epic喜加一公布
詹姆斯得分王之夜打哪队最有利: 詹姆斯得分王之夜打哪队最有利
看3D电影单独买3D眼镜合理吗: 看3D电影单独买3D眼镜合理吗
第五人格白嫖17个联动精华: 第五人格白嫖17个联动精华
南京人为什么不爱逛夫子庙: 南京人为什么不爱逛夫子庙
原子之心游戏概览预告: 原子之心游戏概览预告
原神60级包工头沉迷家园装修: 原神60级包工头沉迷家园装修
鲤鱼Ace看九转大肠: 鲤鱼Ace看九转大肠
Epic免费领取两款游戏: Epic免费领取两款游戏
柯南最强真相终于揭露: 柯南最强真相终于揭露
打死倒车与回直倒车有何区别: 打死倒车与回直倒车有何区别
北京惊现多重冰晕: 北京惊现多重冰晕
速度与激情 有田下山: 速度与激情11 有田下山
IG实力倒退五年: IG实力倒退五年
LOL情人节限定女警皮肤: LOL情人节限定女警皮肤
宋雨琦赵美延合体主持: 宋雨琦赵美延合体主持