胡鑫宇录音笔中表达自杀意愿: 胡鑫宇录音笔中表达自杀意愿
重庆江边疑现恐龙化石: 重庆江边疑现恐龙化石
胡鑫宇系自缢死亡: 胡鑫宇系自缢死亡
米哈游起诉原神内鬼泄密胜诉: 米哈游起诉原神内鬼泄密胜诉
胡鑫宇下落为何100多天后才发现: 胡鑫宇下落为何100多天后才发现
Xiaohu说Ming的硬辅太耀眼: Xiaohu说Ming的硬辅太耀眼
胡鑫宇尸体发现地系原始第一现场: 胡鑫宇尸体发现地系原始第一现场
警方回应鞋带承载胡鑫宇缢吊重量: 警方回应鞋带承载胡鑫宇缢吊重量
电磁炮真是太可爱了: 电磁炮真是太可爱了
LOL新版龙王搞笑彩蛋曝光: LOL新版龙王搞笑彩蛋曝光
胡鑫宇尸检情况公布: 胡鑫宇尸检情况公布
拼夕夕九转大肠有肠的味道吗: 拼夕夕九转大肠有肠的味道吗
梅西破门姆巴佩两度失点: 梅西破门姆巴佩两度失点
彭于晏工作室疑似回应网友催婚: 彭于晏工作室疑似回应网友催婚
少年为解封QQ空间孤身前往深圳: 少年为解封QQ空间孤身前往深圳
举报此人奖励10万元: 举报此人奖励10万元
修复百年前的欧美玩具: 修复百年前的欧美玩具
EDG败者采访: EDG败者采访
梅西封神夜超越C罗: 梅西封神夜超越C罗
胡鑫宇录音笔内容无合成和篡改情况: 胡鑫宇录音笔内容无合成和篡改情况
边牧吃醋将主人养了5年金毛拐跑: 边牧吃醋将主人养了5年金毛拐跑
卡瓦格博峰的秘密: 人类禁区 卡瓦格博峰的秘密
周杰伦香港演唱会: 周杰伦香港演唱会提前3个月
ShowMaker状态: ShowMaker状态
著名乳腺外科专家黄汉源去世: 著名乳腺外科专家黄汉源去世
武汉天河机场免费过夜攻略: 武汉天河机场免费过夜攻略
源自三体的那些流行梗: 源自三体的那些流行梗
王嘉晨回应狂飙拍了100集是玩笑: 王嘉晨回应狂飙拍了100集是玩笑
项羽情限皮肤建模曝光: 项羽情限皮肤建模曝光
赛尔号惊涛海皇波塞冬神谕: 赛尔号惊涛海皇波塞冬神谕