霍格沃茨或成今年最畅销游戏: 霍格沃茨或成今年最畅销游戏
禁止法庭上吃九转大肠: 禁止法庭上吃九转大肠
Rookie谈TheShy问题: Rookie谈TheShy问题
人类史上最强地震: 人类史上最强地震
张颂文爆火后的苦难报道: 张颂文爆火后的苦难报道
个人近战单位: 个人近战单位什么梗
36年前的恐怖片惊世之作: 36年前的恐怖片惊世之作
苹果将推出首款头显: 苹果将推出首款头显
狂飙韩国版预告片: 狂飙韩国版预告片
为何狼队时装争议最大: 为何狼队时装争议最大
如何只用火把通关法环: 如何只用火把通关法环
吴刚回应儿子演狂飙: 吴刚回应儿子演狂飙
JieJie如何击败Kanavi: JieJie如何击败Kanavi
豆瓣9.8分的国剧之王: 豆瓣9.8分的国剧之王
阳光男孩但对抗路情侣: 阳光男孩但对抗路情侣
AMD移动端独显: AMD移动端独显
实测8999元嘎子手机: 实测8999元嘎子手机
狂飙在泰国的影响力: 狂飙在泰国的影响力
阿文看自己在国外爆火: 阿文看自己在国外爆火
papi酱: papi酱说生孩子像抽盲盒
Epic送出小兵大战: Epic送出小兵大战
新监管者守夜人技能: 新监管者守夜人技能
白色情人节2流程实况: 白色情人节2流程实况
电影咒将改编为游戏: 电影咒将改编为游戏
ChatGPT能取代徐静雨吗: ChatGPT能取代徐静雨吗
帮人皇李培楠戒网瘾: 帮人皇李培楠戒网瘾
Uzi谈湖北出高手: Uzi谈湖北出电竞高手
原神哥BeryL安妮辅助: 原神哥BeryL安妮辅助
超凡帝国上线预告片: 超凡帝国上线预告片
杨玉环出装新思路: 杨玉环出装新思路