战鹰点陪玩发现是花少北: 战鹰点陪玩发现是花少北
G2官推发布中国粉丝整活: G2官推发布中国粉丝整活
AL BLG: BLG战胜AL
中小学校内禁设小卖部: 中小学校内禁设小卖部
陕西发现战国时期冲水式厕所: 陕西发现战国时期冲水式厕所
本来还挺喜欢玩王者的: 本来还挺喜欢玩王者的
让ChatGPT推出黑暗森林: 让ChatGPT推出黑暗森林
以为是科长原来是科比: 以为是科长原来是科比
郭晓婷主动加下跪戏: 郭晓婷主动加下跪戏
Bin纳尔TP团战一推三: Bin纳尔TP团战一推三
炉石传说全球价格上涨: 炉石传说全球价格上涨
俄亥俄毒物会传到我国吗: 俄亥俄毒物会传到我国吗
蚁人3为何口碑爆冷: 蚁人3为何口碑爆冷
拳头对不同英雄的态度: 拳头对不同英雄的态度
歌手刘文正去世: 歌手刘文正去世
Switch大限将至了吗: Switch大限将至了吗
线下阿卡丽的神秘商店: 线下阿卡丽的神秘商店
qingtian深陷重围反杀: qingtian深陷重围反杀
穷孩子交钱实习为哪般: 穷孩子交钱实习为哪般
白色情人节恐怖学校: 白色情人节恐怖学校
陈飞宇生图: 陈飞宇生图
上海血液中心联动奥特曼: 上海血液中心联动奥特曼
TT战胜WBG语音曝光: TT战胜WBG语音曝光
零刻ser6 pro上手体验: 零刻ser6 pro上手体验
RTX4060爆料: RTX4060爆料
EDG ELOG乐: EDG ELOG乐
评分9.3的国产经典探案剧: 评分9.3的国产经典探案剧
情人总分分分分: 情人总分分分分
熊出没中狗熊岭有多大: 熊出没中狗熊岭有多大
情人节带女友守垃圾桶: 情人节带女友守垃圾桶