王者荣耀世界实机演示: 王者荣耀世界公布实机演示片段
木乃伊讲了什么故事: 未被删减的木乃伊讲了什么故事
惠斯勒山巨人目击事件解说: 惠斯勒山巨人目击事件解说
新西兰宣布进入国家紧急状态: 新西兰宣布进入国家紧急状态
王力宏公司被冻结901万存款: 王力宏公司被冻结901万存款
富二代挑战流浪生活被饿死: 富二代挑战流浪生活被饿死
专家建议短期别喝产地俄亥俄的牛奶: 专家建议短期别喝产地俄亥俄的牛奶
各解说看TheShy两场比赛被单杀: 各解说看TheShy两场比赛被单杀
日本樱岛火山一月两次剧烈喷发: 日本樱岛火山一月两次剧烈喷发
WBG中上野各种上头开送: WBG中上野各种上头开送
俄亥俄毒物会传到我国吗: 俄亥俄毒物会传到我国吗
韩国民众向土耳其捐赠大量脏衣服: 韩国民众向土耳其捐赠大量脏衣服
LPL春季赛2月14日TOP5: LPL春季赛2月14日TOP5
美俄亥俄州大量动物突然死亡: 美俄亥俄州大量动物突然死亡
RTX4060爆料: RTX4060爆料
第四起气球事件内幕曝光: 第四起气球事件内幕曝光
演员李嘉明路边摆摊卖炒面: 演员李嘉明路边摆摊卖炒面
实拍美俄亥俄州毒云压城: 实拍美俄亥俄州毒云压城
中国专家查看土耳其倒塌房屋: 中国专家查看土耳其倒塌房屋
情人节带女友守垃圾桶: 情人节带女友守垃圾桶
传美国一州拟将买卖囚犯器官合法化: 传美国一州拟将买卖囚犯器官合法化
应急部门回应河南多地有巨响: 应急部门回应河南多地有巨响
盘点刘强东的前半生: 盘点刘强东的前半生
原来老一辈才是恋爱高手: 原来老一辈才是恋爱高手
宝可梦朱紫捕捉效果展示: 宝可梦朱紫捕捉效果展示
长期口呼吸或导致变丑: 长期口呼吸或导致变丑
男子垃圾桶旁捡玫瑰送妻子: 男子垃圾桶旁捡玫瑰送妻子
当南方人第一次去回民饭馆: 当南方人第一次去回民饭馆
白色情人节恐怖学校: 白色情人节恐怖学校
鸥你太美: 鸥你太美