星穹铁道登上中国日报: 星穹铁道登上中国日报
Switch大限将至了吗: Switch大限将至了吗
战神5奎托斯原定死亡: 战神5奎托斯原定死亡
拳头对不同英雄的态度: 拳头对不同英雄的态度
本来还挺喜欢玩王者的: 本来还挺喜欢玩王者的
陕西发现战国时期冲水式厕所: 陕西发现战国时期冲水式厕所
俄亥俄毒物会传到我国吗: 俄亥俄毒物会传到我国吗
G2官推发布中国粉丝整活: G2官推发布中国粉丝整活
情人节我们撕了结婚证: 情人节我们撕了结婚证
谢霆锋888元锋味盆菜: 谢霆锋888元锋味盆菜
两秒拍下从猿进化到人: 两秒拍下从猿进化到人
郭晓婷徐海乔四世情缘: 郭晓婷徐海乔四世情缘
APEX团队死斗练枪模式: APEX团队死斗练枪模式
硬核分析TheShy状态: 硬核分析TheShy状态
Kanavi对位被打爆: Kanavi对位被打爆
姆巴佩两球被吹: 姆巴佩两球被吹
靠星战吃一辈子的演员: 靠星战吃一辈子的演员
线下阿卡丽的神秘商店: 线下阿卡丽的神秘商店
T1教练Sky转为选手: T1教练Sky转为选手
鹈鹕时间都能翻盘: 鹈鹕时间都能翻盘
欧冠看台出现巨幅路飞: 欧冠看台出现巨幅路飞
鬼谷八荒结局动画: 鬼谷八荒结局动画
PLUTO冥王动画预告: PLUTO冥王动画预告
TheShy两场比赛被单杀: TheShy两场比赛被单杀
探秘火腿肠生产流程: 探秘火腿肠生产流程
小狗心思都写脸上了: 小狗心思都写脸上了
TheShy线上细节: TheShy线上细节
三星国行S23最终定价: 三星国行S23最终定价
氯乙烯能不能吸: 氯乙烯能不能吸
东方卫视报道无畏契约: 东方卫视报道无畏契约