用狂铁拿下巅峰第一: 用狂铁拿下巅峰第一
太阳4天内发出两次X级耀斑: 太阳4天内发出两次X级耀斑 
战鹰说CP向的差不多得了: 战鹰说CP向的差不多得了
韩国男子杀中国妻子未遂获减刑: 韩国男子杀中国妻子未遂获减刑
林俊杰周杰伦可惜没如果合作舞台: 林俊杰周杰伦可惜没如果合作舞台
导演何平因病去世: 导演何平因病去世
新加坡卫生部长称不对华入境设限: 新加坡卫生部长称不对华入境设限
雷军卸任小米软件技术公司董事长: 雷军卸任小米软件技术公司董事长
猫和老鼠手游 苏蕊猪八戒皮肤: 猫和老鼠手游 苏蕊猪八戒皮肤
坚决反对针对中国歧视性入境限制措施: 坚决反对针对中国歧视性入境限制措施
外交部回应暂停向日本游客发放签证: 外交部回应暂停向日本游客发放签证
高拉特确认放弃中国国籍: 高拉特确认放弃中国国籍
广电要求向演员开展法律培训: 广电要求向演员开展法律培训
父母错了应该给孩子道歉吗: 父母错了应该给孩子道歉吗
31岁小伙相亲恋爱差点当爷爷: 31岁小伙相亲恋爱差点当爷爷
加州进入紧急状态: 加州进入紧急状态
印度产新冠假药流入中国市场: 印度产新冠假药流入中国市场
奥密克戎毒株肺炎发生率比德尔塔小: 奥密克戎毒株肺炎发生率比德尔塔小
朱紫新精灵吐槽: 朱紫新精灵吐槽
异形大战阿凡达看完头皮发麻: 异形大战阿凡达看完头皮发麻
保洁阿姨夹断猫腿被扣押工资: 保洁阿姨夹断猫腿被扣押工资
劳斯莱斯平均价格首次达50万欧元: 劳斯莱斯平均价格首次达50万欧元
赴韩中国人自费核酸一次8万韩元: 赴韩中国人自费核酸一次8万韩元
灰太狼的羊直播称没有经纪人: 灰太狼的羊直播称没有经纪人
风衣: 别轻易尝试风衣
梨泰院踩踏事故将结束调查: 梨泰院踩踏事故将结束调查
首批赴泰中国旅客感觉像明星: 首批赴泰中国旅客感觉像明星
为什么海水不能浇灭海底火山: 为什么海水不能浇灭海底火山
中方回应美是否分享XBB毒株信息: 中方回应美是否分享XBB毒株信息
徐静雨谈世界体坛第一人: 徐静雨谈世界体坛第一人