大学生活费1万孩子就能成才吗: 大学生活费1万孩子就能成才吗
2050年可能创造出心灵传送吗: 2050年可能创造出心灵传送吗
在女友骂我时突然给她喂东西吃: 在女友骂我时突然给她喂东西吃
狂飙是央八近九年收视第一: 狂飙是央八近九年收视第一
中国政府决定向土叙提供紧急援助: 中国政府决定向土叙提供紧急援助
土耳其男子抱着去世孩子痛哭: 土耳其男子抱着去世孩子痛哭
日本最暴利的合法生意: 日本最暴利的合法生意
众解说看karsa为TheShy卡线: 众解说看Karsa为TheShy卡线
一句四川话引发的血案: 一句四川话引发的血案
世卫称土耳其地震或致2万人死亡: 世卫称土耳其地震或致2万人死亡
知情人称唐小强系回土耳其探亲: 知情人称唐小强系回土耳其探亲
这是什么香菱: 这是什么香菱
UP耗时2年自制机甲浪人泰坦: UP耗时2年自制机甲浪人泰坦
TFBOYS十周年演唱会确认规划中: TFBOYS十周年演唱会确认规划中
宋宁峰向张婉婷求婚: 宋宁峰向张婉婷求婚
麻子演员回应疯驴子只有25岁: 麻子演员回应疯驴子只有25岁
全国第一批缉毒松鼠: 全国第一批缉毒松鼠
土耳其地震对中国是否有影响: 土耳其地震对中国是否有影响
Steam新游戏无感染区试玩: Steam新游戏无感染区试玩
妻子回应将厕所改装成电竞房: 妻子回应将厕所改装成电竞房
宅家女友胡桃: 宅家女友胡桃
济南方特被曝劝辞哺乳期女员工: 济南方特被曝劝辞哺乳期女员工
用王致和做九转大肠给兄弟吃: 用王致和做九转大肠给兄弟吃
恩施人非必要不得前往柬埔寨: 恩施人非必要不得前往柬埔寨
大司马看听说指导组下一站是芜湖: 大司马看听说指导组下一站是芜湖
土耳其大地震的影响有多大: 土耳其大地震的影响有多大
UP挑战全身粘钻石: UP挑战全身粘钻石
动视暴雪净利润同比下降29%: 动视暴雪净利润同比下降29%
游客自曝在泰国遭旅游诈骗: 游客自曝在泰国遭旅游诈骗
挑战一分钟吃一斤羊肉卷: 挑战一分钟吃一斤羊肉卷