刘慈欣二刷球2发现小bug: 刘慈欣二刷球2发现小bug
曝阿凡达系列将跨越万年: 曝阿凡达系列将跨越万年
LOL卡萨丁T0皮肤: LOL卡萨丁T0皮肤
土耳其总统宣布全国哀悼7天: 土耳其总统宣布全国哀悼7天
泰国满大街播放狂飙吸引中国游客: 泰国满大街播放狂飙吸引中国游客
妻子回应将厕所改装成电竞房: 妻子回应将厕所改装成电竞房
中国首支社会救援力量赴土耳其: 中国首支社会救援力量赴土耳其
济南方特被曝劝辞哺乳期女员工: 济南方特被曝劝辞哺乳期女员工
非正唐小强因土耳其地震被埋: 非正唐小强因土耳其地震被埋
原神EP: 原神EP 拈骰冥思之夜
杨紫琼对成龙说这是你的损失: 杨紫琼对成龙说这是你的损失
动视暴雪净利润同比下降29%: 动视暴雪净利润同比下降29%
男子从废墟中抱出新生儿: 男子从废墟中抱出新生儿
原神 仇敌仿佛众水翻腾: 原神 仇敌仿佛众水翻腾
比尔盖茨谈ChatGPT用途: 比尔盖茨谈ChatGPT用途
泰坦陨落新作惨遭EA取消: 泰坦陨落新作惨遭EA取消
蛇蛇女警被抓反向E: 蛇蛇女警被抓反向E
曼城将被扣分或逐出英超: 曼城将被扣分或逐出英超
虞姬星传说: 虞姬星传说皮肤特效预览
女足运动员逃亡路上遇余震: 女足运动员逃亡路上遇余震
众解说看karsa为TheShy卡线: 众解说看Karsa为TheShy卡线
秘鲁发生大规模山体滑坡泥石流: 秘鲁发生大规模山体滑坡泥石流
俄罗斯媳妇感受西湖之美: 俄罗斯媳妇感受西湖之美
AL继承WE意志俯冲0比16: AL继承WE意志俯冲0比16
土耳其废墟中救出一名女孩: 土耳其废墟中救出一名女孩
WBG把FPX当人机打: WBG把FPX当人机打
柯南经典案件 浴室密室: 柯南经典案件浴室密室事件
强震已致土耳其叙利亚超3000人遇难: 强震已致土耳其叙利亚超3000人遇难
火影手游 离谱的高招忍者: 火影手游 离谱的高招忍者
和平精英匹配到米老鼠: 和平精英匹配到米老鼠