微信一手机号可注册两账号: 微信一手机号可注册两账号
普通长相女生才知道的人生真相: 普通长相女生才知道的人生真相
狂魔哥被迪丽热胖表白: 狂魔哥被迪丽热胖表白
商场回应女厕设无遮挡男童便池: 商场回应女厕设无遮挡男童便池
梅西收到三星阿根廷球衣: 梅西收到三星阿根廷球衣
女子身高185应聘少儿老师被拒: 女子身高185应聘少儿老师被拒
LGD AL: LGD AL
直面生育损伤: 直面生育损伤
强迫别人吃原味大肠犯法吗: 强迫别人吃原味大肠犯法吗
君主立宪为何救不了大清: 君主立宪为何救不了大清
女孩花4万在鹤岗买房后卖煎饼挣钱: 女孩花4万在鹤岗买房后卖煎饼挣钱
以性别为由拒聘妇女最高可罚5万: 以性别为由拒聘妇女最高可罚5万
TheShy奎桑提已臻至化境: TheShy奎桑提已臻至化境
赛尔号大结局: 赛尔号大结局
大巴黎官宣姆巴佩伤情: 大巴黎官宣姆巴佩伤情
百年前的1元现在价值百万: 百年前的1元现在价值百万
边牧扔金毛事件是真是假: 边牧扔金毛事件是真是假
守望新地图南极半岛: 守望新地图南极半岛
讨厌没有边界感的人类: 讨厌没有边界感的人类
速度与激情 有田下山: 速度与激情11 有田下山
见过根号2个解的方程吗: 见过根号2个解的方程吗
葛优诉葛优躺表情包侵权胜诉: 葛优诉葛优躺表情包侵权胜诉
凯特琳情人节皮肤: 凯特琳情人节皮肤
爱奇艺回应一号三用被封: 爱奇艺回应一号三用被封
郭帆向UP主透露球2隐藏剧情: 郭帆向UP主透露球2隐藏剧情
峨眉山员工下悬崖未取安全绳: 峨眉山员工下悬崖未取安全绳
国外专业音乐人评价谭维维: 国外专业音乐人评价谭维维
王者荣耀全国大赛开赛: 王者荣耀全国大赛开赛
App弹窗跳转标准发布: App弹窗跳转标准发布
终于理解了女主光环滤镜: 终于理解了女主光环滤镜