成本仅5万的中式恐怖片: 成本仅5万的中式恐怖片
研究生: 研究生讽准研究生纳谏
国服猪妹COS: 国服猪妹COS
龙抬头将在21日晚间上演: 龙抬头将在21日晚间上演
梅西绝杀后返回巴塞罗那: 梅西绝杀后返回巴塞罗那
小龙人贝贝扮演者去世: 小龙人贝贝扮演者去世
最良心的国产泡面: 最良心的国产泡面
建议专家不对通勤提建议: 建议专家不对通勤提建议
因为透视被召回的相机: 因为透视被召回的相机
战鹰看自己破百万粉丝: 战鹰看自己破百万粉丝
继承父母遗产天经地义吗: 继承父母遗产天经地义吗
九品芝麻官暗黑剧情: 九品芝麻官暗黑剧情
红警基地压肉人一块地: 红警基地压肉人一块地
我们LPL有女警的: 我们LPL有女警的
僵毁目前野心最大的MOD: 僵毁目前野心最大的MOD
最后一个RMR名额会是谁: 最后一个RMR名额会是谁
SwordArt回春发挥精彩: SwordArt回春发挥精彩
红警看谁先投降: 红警看谁先投降
TheShy遇上单蝎子: TheShy遇上单蝎子
摸狗的时候突然亲它一下: 摸狗的时候突然亲它一下
感谢B站送来的女朋友: 感谢B站送来的女朋友
火影飞雷神: 火影飞雷神
Zeus刀妹R闪光速预判E: Zeus刀妹R闪光速预判E
听说你喜欢我 虐哭了: 听说你喜欢我 虐哭了
重庆49元全牛油火锅: 重庆49元全牛油火锅
不想上学是什么病: 不想上学是什么病
表情清爽和油腻的区别: 表情清爽和油腻的区别
原神 给长辈发压岁钱: 原神 给长辈发压岁钱
周淑怡dota: 周淑怡dota
全寝唯一过情人节的人: 全寝唯一过情人节的人