研究生: 研究生讽准研究生纳谏
成本仅5万的中式恐怖片: 成本仅5万的中式恐怖片
王者元歌: 王者元歌史诗级削弱
龙抬头将在21日晚间上演: 龙抬头将在21日晚间上演
梅西绝杀后返回巴塞罗那: 梅西绝杀后返回巴塞罗那
小龙人贝贝扮演者去世: 小龙人贝贝扮演者去世
摸狗的时候突然亲它一下: 摸狗的时候突然亲它一下
我放弃了: 我放弃了发SCI一区顶刊
红警基地压肉人一块地: 红警基地压肉人一块地
国产篮球尬剧离大谱: 国产篮球尬剧离大谱
周淑怡dota: 周淑怡dota
最良心的国产泡面: 最良心的国产泡面
国服猪妹COS: 国服猪妹COS
建议专家不对通勤提建议: 建议专家不对通勤提建议
VIT领先8.8k被逆转: VIT领先8.8k被逆转
VIT 0-2 SK: VIT 0-2 SK
TheShy遇上单蝎子: TheShy遇上单蝎子
广东天气有多离谱: 广东天气有多离谱
我们LPL有女警的: 我们LPL有女警的
有钱真的会更开心吗: 有钱真的会更开心吗
肯德基瀑布芝士体验: 肯德基瀑布芝士体验
小钰看Rookie和杰克比心: 小钰看Rookie和杰克比心
大厂: 大厂裸辞收入翻倍
APEX超人强出击: APEX超人强出击
最后一个RMR名额会是谁: 最后一个RMR名额会是谁
练习生都不敢染的发色: 练习生都不敢染的发色
辣椒炒肉: 用5种辣椒做辣椒炒肉
TXT迟到问题不大: TXT迟到问题不大
西游记副导演任凤坡去世: 西游记副导演任凤坡去世
Zeus刀妹R闪光速预判E: Zeus刀妹R闪光速预判E