周杰伦再次创造历史: 周杰伦再次创造历史
米哈游向推特发传票: 米哈游向推特发传票
比赛一半显卡烧了: 比赛一半显卡烧了
国乒至暗时刻: 国乒至暗时刻
黄瑶扮演者: 黄瑶扮演者来B站了
iPhone15Pro新配色: iPhone15Pro新配色
NIP AL: NIP AL
Epic说Steam加油: Epic说Steam加油
网友要逮捕梅西理发师: 网友要逮捕梅西理发师
比亚迪汉EV创世版: 比亚迪汉EV创世版
大明五品以上的出列: 大明五品以上的出列
还原狂飙真实女主孟钰: 还原狂飙真实女主孟钰
森林之子画质优化指南: 森林之子画质优化指南
鸭脖卖不动怪年轻人吗: 鸭脖卖不动怪年轻人吗
卷到吃水煮脱水三体人: 卷到吃水煮脱水三体人
LOL新增自我静音功能: LOL新增自我静音功能
口臭自己为什么闻不到: 口臭自己为什么闻不到
Zeus称就想摇晕对方: Zeus称就想摇晕对方
郭富城再现摇头杀: 郭富城再现摇头杀
专科生毕业后的4年: 专科生毕业后的4年
本科三无如何复试: 本科三无如何复试
Tablo: Tablo来B站了
山西太原排名第一的面馆: 山西太原排名第一的面馆
为何多数飞机餐都不好吃: 为何多数飞机餐都不好吃
鸡你太美英文版: 鸡你太美英文版
森林之子首发体验: 森林之子首发体验
顶流为啥不抗剧: 顶流为啥不抗剧
世界讨厌香菜日: 世界讨厌香菜日
LOL插眼优化: LOL插眼优化
发明湿汉堡的是天才吧: 发明湿汉堡的是天才吧