国乒至暗时刻: 国乒至暗时刻
周杰伦再次创造历史: 周杰伦再次创造历史
UP在漫展COS修女菲比: UP在漫展COS修女菲比
原神 我落泪祈愿零碎: 原神 我落泪祈愿零碎 
刘慈欣 中国2185: 刘慈欣 中国2185
比赛一半显卡烧了: 比赛一半显卡烧了
阿冰退出农村三人行: 阿冰退出农村三人行
游戏史上最离谱的联动: 游戏史上最离谱的联动
wojak是啥梗: wojak是啥梗
Zeus称就想摇晕对方: Zeus称就想摇晕对方
3.7分神作重启地球: 3.7分神作重启地球
森林之子 通关: 森林之子 全网首通关
沙皇小重做: LOL沙皇小重做
悟空打青牛精动作设计: 悟空打青牛精动作设计
人工智能或将用于游戏: 人工智能或将用于游戏
课堂犯困被老师抱讲台哄睡: 课堂犯困被老师抱讲台哄睡
司空震扁鹊新皮肤: 司空震扁鹊新皮肤
给王者玩家的DOTA2教学: 给王者玩家的DOTA2教学
米哈游向推特发传票: 米哈游向推特发传票
火影疾风传究极风暴PV: 火影疾风传究极风暴PV
原子之心感人彩蛋: 原子之心感人彩蛋
郭富城再现摇头杀: 郭富城再现摇头杀
设计师谈LOL匹配机制: 设计师谈LOL匹配机制
专科生毕业后的4年: 专科生毕业后的4年
还原狂飙真实女主孟钰: 还原狂飙真实女主孟钰
鸭脖卖不动怪年轻人吗: 鸭脖卖不动怪年轻人吗
王刚 特色烫皮兔: 王刚 特色烫皮兔
黄瑶扮演者: 黄瑶扮演者来B站了
巨石强森 空腹爬楼机训练: 巨石强森 空腹爬楼机训练
查分后如何给导师发邮件: 查分后如何给导师发邮件