黑神话悟空概念场景复刻CG: 黑神话悟空概念场景复刻CG
卷不赢就不要轻易尝试的造型: 卷不赢就不要轻易尝试的造型
当姑爷听到老丈人要离婚了: 当姑爷听到老丈人要离婚了
JackeyLove称没有LOL早进厂了: JackeyLove称没有LOL早进厂了
日本萝莉看阿里嘎多美羊羊桑: 日本萝莉看阿里嘎多美羊羊桑
多家快递公司宣布春节无休: 多家快递公司宣布春节无休
女孩博士毕业不社交遭妈妈吐槽: 女孩博士毕业不社交遭妈妈吐槽
阻断药试药员应聘窗口前排长队: 阻断药试药员应聘窗口前排长队
腾讯网易抢占MMO游戏市场: 腾讯网易抢占MMO游戏市场
老人被救儿子7年后再次上门感谢: 老人被救儿子7年后再次上门感谢
脑梗父亲摔倒儿子飞奔抱头: 脑梗父亲摔倒儿子飞奔抱头
7旬担保人替朋友扛下280万债务: 7旬担保人替朋友扛下280万债务
河南已顺利渡过疫情高峰: 河南已顺利渡过疫情高峰
15岁狗去世前不吃饭默默躲进树林: 15岁狗去世前不吃饭默默躲进树林
官方回应长清一中高考听力卡顿: 官方回应长清一中高考听力卡顿
见义勇为受伤的南京胖哥举办婚礼: 见义勇为受伤的南京胖哥举办婚礼
胖50斤也封印不了的颜值: 胖50斤也封印不了的颜值
女子CT报告显示右肺狗日: 女子CT报告显示右肺狗日
河南新冠病毒感染率近九成: 河南新冠病毒感染率近九成
北京不少市民收到移动奇怪短信: 北京不少市民收到移动奇怪短信
韩游客称就餐时遭厨师芥末袭击: 韩游客称就餐时遭厨师芥末袭击
大学生寒假应聘搓澡工攒钱旅游: 大学生寒假应聘搓澡工攒钱旅游
Epic送头等舱危机: Epic送头等舱危机
林俊杰去泰国看BLACKPINK演唱会: 林俊杰去泰国看BLACKPINK演唱会
奥密克戎毒株致病性明显下降: 奥密克戎毒株致病性明显下降
Rookie 喻文波在滔博是老大: Rookie 喻文波在滔博是老大
马丁内斯执教葡萄牙队: 马丁内斯执教葡萄牙队
战鹰曾异国他乡被困门外: 战鹰曾异国他乡被困门外
探店颠覆者真探唐仁杰: 探店颠覆者真探唐仁杰
你有多久没有抬起头认真地数过星星: 你有多久没有抬起头认真地数过星星