打扮成混混去见日本女友家长: 打扮成混混去见日本女友家长
少年老成其实是件可怕的事情: 少年老成其实是件可怕的事情
土狗痊愈后被家里土著孤立: 土狗痊愈后被家里土著孤立
王思聪打人被行政处罚: 王思聪打人被行政处罚
胡鑫宇舅舅称如果他存在就该有痕迹: 胡鑫宇舅舅称如果他存在就该有痕迹
印尼已为中国游客准备好红毯: 印尼已为中国游客准备好红毯
男子情绪崩溃在医院走廊连扇耳光: 男子情绪崩溃在医院走廊连扇耳光
百万亚瑟王: 百万亚瑟王新作试玩
王者五款兔年限定特效: 王者五款兔年限定特效
UP接到一个让人难过的诈骗电话: UP接到一个让人难过的诈骗电话
上海迪士尼疯狂动物城今年将建成: 上海迪士尼疯狂动物城今年将建成
第十届新国辩: 第十届新国辩
男子回家过年18人睡2大炕唠嗑: 男子回家过年18人睡2大炕唠嗑
46岁罗纳尔多成功求婚: 46岁罗纳尔多成功求婚
前巴萨高层怒骂梅西: 前巴萨高层怒骂梅西
奥比岛央视动漫联动宣传片: 奥比岛央视动漫联动宣传片
当国标生用自己的专业耍帅: 当国标生用自己的专业耍帅
韩方回应涉嫌歧视中国人问题: 韩方回应涉嫌歧视中国人问题
人民文娱评中国奇谭: 人民文娱评中国奇谭
律师称达成和解王某某将免于处罚: 律师称达成和解王某某将免于处罚
傻子瓜子创始人年广九逝世: 傻子瓜子创始人年广九逝世
下一个破亿视频: 下一个破亿视频预测
周杰伦转发家有儿女片段: 周杰伦转发家有儿女片段
爱奇艺回应上海市消保委点名不厚道: 爱奇艺回应上海市消保委点名不厚道
师父粤语配音版将上线: 师父粤语配音版将上线
敢杀我的马: 敢杀我的马
全球物物交换最后换到什么: 全球物物交换最后换到什么
贺岁喜剧: 香港最强贺岁喜剧为什么牛
英雄联盟春节全场半价预告: 英雄联盟春节全场半价预告
12万人打出8.9分的复仇爽剧: 12万人打出8.9分的复仇爽剧