油画村: 欧美一半多油画来自中国这个村
GTA6首支预告片内容疑似泄漏: GTA6首支预告片内容疑似泄漏
小乔新皮肤特效太惊艳: 小乔新皮肤特效太惊艳
爱奇艺被曝禁止HDMI连线播放: 爱奇艺被曝禁止HDMI连线播放
北大教授去世儿子拒买天价骨灰盒: 北大教授去世儿子拒买天价骨灰盒
曹德旺称要捐100亿建世界一流名校: 曹德旺称要捐100亿建世界一流名校
明起多国来华将严查48小时核酸: 明起多国来华将严查48小时核酸
制片人张萌被判三年: 制片人张萌被判三年
尼泊尔失事航班: 尼泊尔失事航班黑匣子被找到
石原泥美上电视啦: 石原泥美上电视啦
周杰伦演唱会回应负评: 周杰伦演唱会回应负评
如何把小商品拍成高端广告: 如何把小商品拍成高端广告
大哥凌晨火车上为乘客献唱: 大哥凌晨火车上为乘客献唱
夫妻为宝宝取8个字姓名共56画: 夫妻为宝宝取8个字姓名共56画
春节尽量不带低龄儿童聚餐聚会: 春节尽量不带低龄儿童聚餐聚会
鸿蒙5G WIKO体验: 鸿蒙5G WIKO体验
后羿射下来的太阳是谁: 后羿射下来的太阳是谁
宝可梦朱紫 小智的甲贺忍蛙: 宝可梦朱紫 小智的甲贺忍蛙
狗子突然抑郁竟是毛衣买小了: 狗子突然抑郁竟是毛衣买小了
红警被迫性潜伏: 红警被迫性潜伏
Cat请AG全员吃散伙宴: Cat请AG全员吃散伙宴
比亚迪造舰队助力中国汽车出口: 比亚迪造舰队助力中国汽车出口
LOL坦克装备改动预览: LOL坦克装备改动预览 
原神3.4良心新池子: 原神3.4良心新池子
PDD逆水寒充值成榜一大哥: PDD逆水寒充值成榜一大哥
恶搞之家 被嫌弃的Meg的一生: 恶搞之家 被嫌弃的Meg的一生
李现说刘亦菲是醋的女儿: 李现说刘亦菲是醋的女儿
阿尔特塔避免冲突升级飞奔拉回球员: 阿尔特塔避免冲突升级飞奔拉回球员
恢复对涉港澳台营业性演出的受理和审批: 恢复对涉港澳台营业性演出的受理和审批
亲历者讲述坐飞机遇大风悬停: 亲历者讲述坐飞机遇大风悬停