上海迪士尼疯狂动物城今年将建成: 上海迪士尼疯狂动物城今年将建成
打扮成混混去见日本女友家长: 打扮成混混去见日本女友家长
土狗痊愈后被家里土著孤立: 土狗痊愈后被家里土著孤立
王思聪打人被行政处罚: 王思聪打人被行政处罚
胡鑫宇舅舅称如果他存在就该有痕迹: 胡鑫宇舅舅称如果他存在就该有痕迹
45岁女子带5个孩子嫁给初恋: 45岁女子带5个孩子嫁给初恋
韩方回应涉嫌歧视中国人问题: 韩方回应涉嫌歧视中国人问题
男子情绪崩溃在医院走廊连扇耳光: 男子情绪崩溃在医院走廊连扇耳光
PDD看鹅鸭杀给自己做的皮肤: PDD看鹅鸭杀给自己做的皮肤
王者荣耀兔年春节福利指南: 王者荣耀兔年春节福利指南
46岁罗纳尔多成功求婚: 46岁罗纳尔多成功求婚
爱奇艺回应上海市消保委点名不厚道: 爱奇艺回应上海市消保委点名不厚道
美国一列车滞留29小时乘客以为被劫持: 美国一列车滞留29小时乘客以为被劫持
战鹰赢棋后跑到厕所偷笑: 战鹰赢棋后跑到厕所偷笑
娃娃脸反派更带感: 娃娃脸反派更带感
奥比岛央视动漫联动宣传片: 奥比岛央视动漫联动宣传片
当国标生用自己的专业耍帅: 当国标生用自己的专业耍帅
英国UP看B站跨晚: 英国UP看B站跨晚
广东江门古井烧鹅: 广东江门古井烧鹅
刘鑫新增被执行人信息: 刘鑫新增被执行人信息
下一个破亿视频: 下一个破亿视频预测
一下子就有春晚那味儿了: 一下子就有春晚那味儿了
米哈游辟谣年终奖108薪: 米哈游辟谣年终奖108薪
师父粤语配音版将上线: 师父粤语配音版将上线
裸眼3D是如何实现的: 裸眼3D是如何实现的
CPI: CPI
周杰伦转发家有儿女片段: 周杰伦转发家有儿女片段
超英艾希: 超英艾希
历史剧: 国产历史剧为什么没了
全球物物交换最后换到什么: 全球物物交换最后换到什么